border_size=1
usage=map

Gg          , Gg          , Gs^Fp       , Gg          , Hh          , Gg          , Wo          , Gg          , Gg          , Gg          , Gg          , Gg          , Gg          , Gg          , Gg          , Gg          , Gg          , Gg          , Gg          , Gg          , Gg          , Gg          , Gg          , Gg          , Gg          , Gg          , Gg          , Gg          , Gg          , Gg          , Gg          , Gg          , Gg          , Gg          , Gg          , Gg          , Rr          , Gg          , Gg          
Gg          , Gs^Fp       , Gs^Fp       , Gs^Fp       , Hh          , Mm          , Wo          , Wo          , Gg          , Gg          , Gg          , Gg          , Gg          , Rr          , 8 Rr        , Gg          , Rr          , Gg          , Rr          , Gg          , Rr          , Gg          , Rr          , Gg          , Rr          , Gg          , Rr          , Gg          , Rr          , Gg          , Rr          , Rr          , Rr          , Rr          , Rr          , Rr          , 3 Rr        , Rr          , Rr          
Gg          , Gs^Fp       , Gs^Fp       , Gs^Fp       , Hh          , Mm          , Mm          , Wo          , Wo          , Gg          , Gg^Vh       , Gg          , Gg          , Rr          , Rr          , Rr          , Gg          , Rr          , Gg          , Rr          , Gg          , Rr          , Gg          , Rr          , Gg          , Rr          , Gg          , Rr          , Gg          , Rr          , Gg          , Gg          , Gg          , Rr          , Rr          , Gg          , Rr          , Gg          , Rr          
Gg          , Gs^Fp       , Hh          , Hh          , Mm          , Mm          , Mm          , Hh          , Wo          , Wo          , Wo          , Gg          , Gg          , Gg          , Gg          , Gg          , Gg          , Gg^Vh       , Gg          , Gg          , Gg          , Gg          , Gg          , Gg          , Mm          , Gg          , Mm          , Hh^Fp       , Hh^Fp       , Gg          , Ea          , Ea          , Ea          , Gg          , Gg          , Gg          , Rr          , Gg          , Gg          
Gg          , Hh          , Hh          , Mm          , Mm          , Mm          , Mm          , Hh          , Wo          , Wo          , Wo          , Wo          , Hh^Fp       , Gg          , Gg          , Gg^Vh       , Ea          , Ea          , Gg          , Gg          , Gg          , Gg          , Mm          , Mm          , Mm          , Mm          , Mm          , Mm          , Hh^Fp       , Gg          , Gg          , Ea          , Gg          , Gg^Vh       , Gg          , Rr          , Gg          , Gg          , Gg          
Gg          , Hh          , Mm          , Mm          , Mm          , Mm          , Mm          , Hh          , Hh^Fds      , Wo          , Wo          , Wo          , Mm          , Hh^Fp       , Hh^Fp       , Gg          , Gg          , Gg          , Hh^Fp       , Hh^Fp       , Mm          , Hh^Fp       , Mm          , Mm          , Hh^Fp       , Mm          , Mm          , Hh^Fp       , Hh^Fp       , Hh^Fp       , Hh^Fp       , Gg          , Gg          , Gg          , Rr          , Rr          , Gg          , Gg          , Gg          
Gg          , Hh          , Mm          , Mm          , Mm          , Mm          , Hh          , Hh          , Hh^Fds      , Gg          , Gg          , Wo          , Wo          , Mm          , Mm          , Hh^Fp       , Mm          , Hh^Fp       , Mm          , Mm          , Hh^Fp       , Mm          , Hh^Fp       , Hh^Fp       , Hh^Fp       , Mm          , Hh^Fp       , Hh^Fp       , Hh^Fp       , Hh^Fp       , Gs^Fp       , Hh^Fp       , Gs^Fp       , Rr          , Gg^Fet      , Gs^Fp       , Gg^Fet      , Gg          , Gs^Fp       
Gg          , Mm          , Mm          , Mm          , Hh          , Hh          , Hh^Fds      , Mm          , Gs^Fp       , Gs^Fp       , Gg          , Gg          , Chw         , Wo          , Wo          , Mm          , Hh^Fp       , Mm          , Hh^Fp       , Hh^Fp       , Wo          , Wo          , Gg          , Hh^Fp       , Hh^Fp       , Hh^Fp       , Hh^Fp       , Hh^Fp       , Hh^Fp       , Gs^Fp       , Gs^Fp       , Gs^Fp       , Rr          , Rr          , Gs^Fp       , Gg^Fet      , Mm          , Gs^Fp       , Mm          
Gg          , Mm          , Hh          , Hh          , Hh^Fds      , Hh^Fds      , Gg^Fet      , Gg^Fet      , Gg          , Gg          , Gg          , Gg          , Rr          , Rr          , Chw         , Wo          , Wo          , Hh^Fp       , Wo          , Wo          , Gg          , Gg^Vh       , Gg          , Gg          , Ea          , Gg          , Gg          , Gg          , Gg          , Gg          , Rr          , Rr          , Gg          , Gs^Fp       , Gs^Fp       , Gs^Fp       , Mm          , Mm          , Mm          
Gg          , Hh          , Hh          , Hh^Fds      , Gg^Fet      , Gg^Fet      , Gs^Fdf      , Gs^Fdf      , Gg          , Gg          , Gg          , Gg          , Rr          , Gg          , Gg          , Wo          , Wo          , Wo          , Wo          , Gg          , Gs^Vht      , Gg          , Rr          , Ea          , Rr          , Gg          , Rr          , Gg          , 5 Rr        , Gg          , Rr          , Gg          , Gg          , Gg          , Gg          , Gs^Fp       , Mm          , Mm          , Mm          
Gg          , Hh          , Hh          , Gg^Fet      , Gg^Fet      , Gs^Fp       , Gg          , Gg          , Gg          , Gg          , Gg          , Gg          , Rr          , Gg          , Gg          , Gg          , Gg          , Wo          , Wo          , Wo          , Wo          , Chw         , Gg          , Rr          , Gg          , Rr          , Gg          , Rr          , Rr          , Rr          , Gg          , Gg          , Gg^Vh       , Gg          , Gg          , Gs^Fp       , Gs^Fp       , Mm          , Gs^Fp       
Gg          , Hh          , Gs^Fp       , Gs^Fp       , Gs^Fp       , Gg          , Gg          , Gs^Vh       , Gg          , Gg          , Gg          , Gg          , Rr          , Gg          , Gg          , Gg^Vh       , Gg          , Gg          , Gg          , Wo          , Wo          , Wo          , Wo          , Gg          , Gg          , Gg          , Gg          , Gg          , Gg          , Rr          , Rr          , Rr          , Rr          , Gg          , Rr          , Gg          , Gg          , Gs^Fp       , Ms^Xm       
Gg          , Gs^Fp       , Gs^Fp       , Gs^Fp       , Gg          , Gg          , Gg          , Gg          , Gg          , Gg          , Gg          , Gg          , Rr          , Gg          , Gg          , Gg          , Gg          , Gg^Vh       , Gg          , Gg          , Gg          , Wo          , Wo          , Wo          , Wo          , Gg^Vh       , Gg          , Gg          , Gg          , Gg          , Gg          , Gg          , Gg          , Rr          , Rr          , Rr          , Ms^Xm       , Ms^Xm       , Gs^Fp       
Gg          , Gs^Fp       , Gg          , Gg          , Gg          , Gg          , Gg          , Gg          , Gg          , Ea          , Ea          , Gg          , Rr          , 1 Gg        , Gg          , Gg          , Gg          , Gg          , Gg          , Gg          , Gg          , Gg          , Gg          , Wo          , Wo          , Gg          , Gg          , Gg          , Gg^Vh       , Gg          , Gg          , Gg          , Hh^Fp       , Hh^Fp       , Ms^Xm       , Ms^Xm       , Mm          , Rr          , Gg          
Gg          , Gs^Fp       , Gg          , Gs^Vh       , Gg          , Gg          , Gg          , Gg          , Gg          , Ea          , Ea          , Gg          , Rr          , Rr          , Gg          , Gg          , Gg          , Gg^Vh       , Gg          , Gg          , Gg          , Gg          , Gg          , Wo          , Wo          , Gg          , Gg          , Gg          , Gg          , Gg          , Hh^Fp       , Hh^Fp       , Ms^Xm       , Ms^Xm       , Mm          , Mm          , Mm          , Rr          , Rr          
Gg          , Gs^Fp       , Gg          , Gg          , Gs^Fp       , Gg          , Gg          , Gg          , Gg          , Gg          , Gg          , Gg          , Gg          , Rr          , Rr          , Gg          , Gg^Vh       , Gg          , Gg          , Gg          , Gg          , Gg          , Ms^Xm       , Wo          , Md^Xm       , Md^Xm       , Md^Xm       , Md^Xm       , Md^Xm       , Hh^Fp       , Ms^Xm       , Ms^Xm       , Mm          , Mm          , Mm          , Mm          , Mm          , Mm^Vhh      , Hh^Fp       
Ms^Xm       , Gg          , Ms^Xm       , Gs^Fp       , Gs^Fp       , Gs^Fp       , Gg          , Gg          , Gg          , Gg          , Gg          , Gg          , Gg          , Gg          , Rr          , Gg          , Gg          , Gg          , Gg          , Gg          , Gg          , Ms^Xm       , Ms^Xm       , Ms^Xm       , Wo          , Wo          , Wo          , Wo          , Wo          , Ms^Xm       , Wo          , Mm          , Mm          , Mm          , Mm          , Mm          , Hh^Fp       , Hh^Fp       , Gg          
Gg          , Ms^Xm       , Gg^Fet      , Ms^Xm       , Ms^Xm       , Ms^Xm       , Mm          , Gg          , Gg          , Gg          , Gg          , Gg          , Gg          , Gg          , Rr          , Rr          , Gg          , Gg          , Gg          , Gg          , Gg          , Ms^Xm       , Ms^Xm       , Wo          , Gg          , Chw         , Chw         , Wo          , Wo          , Wo          , Wo          , Wo          , Mm          , Mm          , Hh^Fp       , Hh^Fp       , Gg^Vh       , Gg          , Gg          
Gg          , Gs^Fp       , Gs^Fp       , Gs^Fp       , Hh^Fp       , Mm          , Mm          , Hh^Fp       , Gg          , Gg          , Gg          , Gg          , Gg^Wm       , Gg          , Gg          , Rr          , Gg          , Gg          , Gg          , Gg          , Ms^Xm       , Ms^Xm       , Wo          , Wo          , Gg          , Gg          , Gg          , Gg          , Gg^Vh       , Ms^Xm       , Wo          , Wo          , Wo          , Hh^Fp       , Hh^Fp       , Hh^Fp       , Gg          , Gg          , Gg          
Gg          , Gg^Fet      , Gg          , Hh^Fp       , Mm          , Mm          , Hh^Fp       , Hh^Fp       , Hh^Fp       , Gg          , Gg          , Gg          , Gg          , Gg          , Gg          , Rr          , Rr          , Gg          , Ms^Xm       , Gg          , Ms^Xm       , Wo          , Wo          , Gg          , Gg          , Gg          , Gg          , Gg          , Gg          , Gg          , Hh^Fp       , Wo          , Wo          , Wo          , Wo          , Gg          , Gg          , Gg          , Gg          
Gg          , Gg          , Gg          , Hh^Fp       , Hh^Fp       , Mm          , Mm          , Hh^Fp       , Gg^Fet      , Gg^Fet      , Gg^Fet      , Gg          , Gg          , Gg          , Gg          , Rr          , Rr          , Wo          , Wo          , Ms^Xm       , Wo          , Wo          , Gg          , Gg          , Gg          , Gg          , Gg          , Gg          , Gg          , Gg          , Hh^Fp       , Hh^Fp       , Mm          , Wo          , Wo          , Wo          , Wo          , Gg          , Gg          
Gg          , Gs^Fp       , Gg          , Gg          , Gg          , Hh^Fp       , Hh^Fp       , Mm          , Mm          , Gg^Fet      , Hh^Fp       , Gg^Fet      , Hh^Fp       , Gg^Fet      , Hh^Fp       , Wo          , Wo          , Wo^Bw\      , Wo^Bw\      , Wo          , Gg          , Gg          , Gg          , Gg          , Gg          , Gg          , Gg          , Gg          , Gg          , Gg          , Gs^Fp       , Hh^Fp       , Mm          , Mm          , Mm          , Wo          , Wo          , Wo          , Wo          
Gg          , Gs^Fp       , Gs^Fp       , Gg          , Gg          , Gg          , Gs^Fp       , Hh^Fp       , Hh          , Mm          , Mm          , Hh          , Mm          , Hh^Fp       , Wo          , Wo          , Wo          , Wo          , Gs^Vh       , Kh          , Rr          , Gg          , Gg          , Ea          , Ea          , Gg          , Gg          , Gg          , Gg          , Gs^Fp       , Hh^Fp       , Hh^Fp       , Hh^Fp       , Mm          , Mm          , Wo          , Wo          , Wo          , Wo          
Gg          , Gs^Fp       , Gg^Fet      , Gg          , Gg          , Gg          , Gg          , Gs^Fp       , Gs^Fp       , Hh          , Hh          , Md^Xm       , Md^Xm       , Md^Xm       , Md^Xm       , Md^Xm       , Gg          , Gg          , Gg          , Gg          , Rr          , Gg^Vh       , Gg          , Ea          , Gg          , Gg          , Wo          , Gg          , Gg          , Gs^Fp       , Hh^Fp       , Hh^Fp       , Hh^Fp       , Mm          , Mm          , Mm          , Mm          , Wo          , Wo          
Gg          , Gg          , Gg          , Gg          , Gg          , Gg          , Gg          , Gg          , Gg          , Gs^Fp       , Gs^Fp       , Mm          , Gs^Fp       , Mm          , Gg^Fet      , Gg          , Gg          , Gg          , Gg          , Gg          , Gg          , Rr          , Gs^Fp       , Gg          , Gg          , Gg          , Gg          , Gg          , Gg          , Gs^Fp       , Hh^Fp       , Hh^Fp       , Mm          , Mm          , Mm          , Mm          , Mm          , Wo          , Wo          
Gg          , Gg          , Gg          , Gg          , Gg          , Gg^Vh       , Gg          , Gg          , Gg          , Gg          , Gs^Fp       , Gs^Fp       , Gg          , Gg^Fet      , Gg          , Gg          , Gg          , Gg^Vh       , Gg          , Gg          , Gg          , 2 Rr        , Gs^Fp       , Gg          , Gg          , Gg^Vh       , Gg          , Gg          , Gg          , Gs^Fp       , Gs^Fp       , Hh^Fp       , Hh^Fp       , Mm          , Hh^Fp       , Hh^Fp       , Mm          , Wo          , Wo          
Wo          , Wo          , Wo          , Gg          , Gg          , Gg          , 7 Gg        , Gg^Vh       , Gg          , Gg          , Gg          , Gs^Fp       , Hh          , Gg          , Hh          , Gg          , Gg          , Gg          , Gg          , Ww          , Wo          , Rr          , Rr          , Gg          , Gg          , Gg          , Gg          , Gg          , Wo          , Gg          , Gs^Fp       , Hh^Fp       , Hh^Fp       , Hh^Fp       , Gs^Fp       , Gs^Fp       , Gs^Fp       , Gs^Fp       , Gg          
Wo          , Wo          , Wo          , Gg          , Gg          , Gg          , Rr          , Rr          , Gg          , Gg          , Hh          , Hh          , Wo          , Hh          , Wo          , Wo          , Wo          , Gg          , Gg          , Gg          , Gg          , Gg          , Gg          , Rr          , Rr          , Rr          , Rr          , Gg          , Gg          , Gg          , Gs^Fp       , Gs^Fp       , Gs^Fp       , Gs^Fp       , Gg          , Gs^Fp       , Ea          , Ea          , Gg          
