border_size=1
usage=map

Mm^Xm       , Mm^Xm       , Mm^Xm       , Mm^Xm       , Mm^Xm       , Mm^Xm       , Qxe         , Qxe         , Cud         , Qxe         , Rr          , Rr          , Rr          , Rr          , Rr          , Rr          , Rr          , Rr          , Rr          , Mm^Xm       , Mm^Xm       , Mm^Xm       , Mm^Xm       , Mm^Xm       , Mm^Xm       , Ms^Xm       
Mm^Xm       , Mm^Xm       , Mm^Xm       , Mm^Xm       , Mm^Xm       , Mm^Xm       , Cud         , Qxu^Bs/     , Rr          , Qxe         , Rr          , Rr          , Rr          , Rr          , Rr          , Rr          , Rr          , Rr          , Rr          , Mm^Xm       , Mm^Xm       , Mm^Xm       , Mm^Xm       , Mm^Xm       , Cud         , Mm^Xm       
Mm^Xm       , Mm^Xm       , Mm^Xm       , Mm^Xm       , Mm^Xm       , Mm^Xm       , Qxu^Bs|     , Qxu^Bs\     , Cud         , Qxe         , Rr          , Rr          , Rr          , Rr          , Rrc         , Rr          , Rr          , Rr          , Rr          , Qxu^Bs\     , Qxu^Bs\     , Ql          , Qxu^Bs/     , Qxu^Bs/     , Qxu^Bs|     , Mm^Xm       
Mm^Xm       , Mm^Xm       , Mm^Xm       , Mm^Xm       , Mm^Xm       , Mm^Xm       , Cud         , Ql          , Rr          , Qxe         , Rr          , Rr          , Rr          , Rr          , Rr          , Rr          , Rr          , Rr          , Rr          , Ql          , Qxu^Bs/     , Cud         , Qxu^Bs\     , Mm^Xm       , Qxu^Bs|     , Mm^Xm       
Mm^Xm       , Mm^Xm       , Mm^Xm       , Mm^Xm       , Qxu^Bs/     , Qxu^Bs/     , Qxu^Bs|     , Qxu^Bs\     , Cud         , Qxe         , Rr          , Rr          , Rr          , Rr          , Rr          , Rr          , Rr          , Rr          , Rr          , Qxu^Bs/     , Qlf         , Mm^Xm       , Mm^Xm       , Qxu^Bs\     , Qxu^Bs|     , Mm^Xm       
Mm^Xm       , Mm^Xm       , Cud         , Qxu^Bs/     , Qxe         , Qxe         , Cud         , Qxe         , Qxe         , Rr          , Ql          , Rr          , Ql          , Ea          , Ql          , Ea          , Ql          , Rr          , Ql          , Rp          , Cud         , Mm^Xm       , Mm^Xm       , Mm^Xm       , Qxu^Bs|     , Mm^Xm       
Mm^Xm       , Mm^Xm       , Mm^Xm       , Qxu^Bs\     , Qxu^Bs\     , Qxe         , Qxe         , Qxu^Bs\     , Qxu^Bs\     , Qxe         , Qxe         , Qxe         , Qxe         , Qxe         , Qxe         , Qxe         , Qxe         , Qxe         , Qxu^Bs/     , Qxu^Bs/     , Qxu^Bs|     , Mm^Xm       , Mm^Xm       , Mm^Xm       , Cud         , Mm^Xm       
Mm^Xm       , Mm^Xm       , Mm^Xm       , Mm^Xm       , Mm^Xm       , Qxu^Bs\     , Qxu^Bs\     , Qxe         , Qxu^Bs/     , Cud         , Qxu^Bs\     , Qxe         , Qxu^Bs/     , Cud         , Qxu^Bs\     , Qxe         , Qxu^Bs/     , Cud         , Qxu^Bs\     , Qxe         , Qxu^Bs|     , Mm^Xm       , Qxu^Bs/     , Qxu^Bs/     , Mm^Xm       , Mm^Xm       
Rp          , Mm^Xm       , Rp          , Rp          , Rp          , Qlf         , Qxu^Bs/     , Cud         , Qlf         , Qxe         , Rp          , Cud         , Rp          , Qxe         , Rp          , Cud         , Rp          , Qxe         , Qxe         , Qxu^Bs\     , Cud         , Qxu^Bs/     , Mm^Xm       , Mm^Xm       , Mm^Xm       , Mm^Xm       
Rp          , Rp          , Rp          , Rp          , Qxu^Bs/     , Qxu^Bs/     , Qlf         , Cud         , Rp          , Rp          , Rp          , Rp          , Rp          , Rp          , Rp          , Qxu^Bs|     , Rp          , Rp          , Rp          , Rp          , Rp          , Md^Xm       , Md^Xm       , Md^Xm       , Md^Xm       , Md^Xm       
Rp          , Rp          , Rp          , Cud         , Qxu^Bs\     , Rp          , Qlf         , Cud         , Rp          , Rp          , Rp          , Urb         , Rp          , Rp          , Rp          , Cud         , Rp          , Rp          , Rp          , Rp          , Rp          , Md^Xm       , Md^Xm       , Md^Xm       , Md^Xm       , Md^Xm       
Rp          , Rp          , Rp          , Qxu^Bs|     , Rp          , Qxu^Bs\     , Cud         , Cud         , Qlf         , Rp          , Rp          , Rp          , Rp          , Rp          , Mm^Xm       , Qlf         , Md^Xm       , Md^Xm       , Md^Xm       , Md^Xm       , Md^Xm       , Md^Xm       , Md^Xm       , Gll^Ftr     , Gll^Ftr     , Gll^Ftr     
Qlf         , Qlf         , Qlf         , Qxu^Bs|     , Qlf         , Qlf         , Cud         , Md^Xm       , Md^Xm       , Md^Xm       , Md^Xm       , Md^Xm       , Mm^Xm       , Mm^Xm       , Mm^Xm       , Mm^Xm       , Gll^Ftr     , Gll^Ftr     , Md^Xm       , Md^Xm       , Md^Xm       , Md^Xm       , Md^Xm       , Gll^Ftr     , Gll^Ftr     , Gll^Ftr     
Cud         , Cud         , Cud         , Cud         , Cud         , Cud         , Cud         , Gll^Ftr     , Gll^Ftr     , Gll^Ftr     , Gll^Ftr     , Mm^Xm       , Ce          , Ce          , Ce          , Ce          , Ce          , Gll^Ftr     , Gll^Ftr     , Md^Xm       , Gll^Ftr     , Md^Xm       , Gll^Ftr     , Gll^Ftr     , Gll^Ftr     , Gll^Ftr     
Gll^Ftr     , Gll^Ftr     , Gll^Ftr     , Gll^Ftr     , Gll^Ftr     , Gll^Ftr     , Cud         , Gll^Ftr     , Gll^Ftr     , Gll^Ftr     , Gll^Ftr     , Ea          , Gll^Ftr     , Qxe         , Qxe         , Qxe         , Gll^Ftr     , Ea          , Gll^Ftr     , Gll^Ftr     , Gll^Ftr     , Gll^Ftr     , Gll^Ftr     , Gll^Ftr     , Gll^Ftr     , Gll^Ftr     
Md^Xm       , Gll^Ftr     , Md^Xm       , Gll^Ftr     , Md^Xm       , Gll^Ftr     , Md^Xm       , Gll^Ftr     , Md^Xm       , Gll^Ftr     , Gll^Ftr     , Gll^Ftr     , Qxe         , Qxe         , Rr          , Qxe         , Qxe         , Qxe         , Ce          , Gll^Ftr     , Md^Xm       , Gll^Ftr     , Qxu^Bs|     , Gll^Ftr     , Gll^Ftr     , Gll^Ftr     
Wwt         , Md^Xm       , Wwt         , Md^Xm       , Wwt         , Md^Xm       , Wwt         , Md^Xm       , Wwt         , Ce          , Ce          , Ce          , Ce          , Rr          , Rrc         , Rr          , Ce          , Ce          , Wwt         , Ce          , Md^Xm       , Md^Xm       , Cud         , Gll^Ftr     , Wwt         , Gg          
Wwt         , Wwt         , Wwt^Bw|     , Wwt         , Wwt         , Wwt         , Wwt         , Wwt         , Wwt         , Wwt         , Wwt^Bw|     , Wwt         , Gll^Ftr     , Wwt         , Wwt         , Wwt         , Gll^Ftr     , Wwt         , Wwt         , Wwt         , Wwt         , Wwt         , Qxu^Bs|     , Wwt         , Wwt         , Wwt         
Wwt         , Wwt         , Wwt^Bw|     , Wwt         , Wwt^Bw/r    , Wwt^Bw\r    , Wwt^Bw/r    , Wwt^Bw\r    , Wwt^Bw\r    , Wwt         , Wwt^Bw|     , Wwt         , Gll^Ftr     , Gll^Ftr     , Gll^Ftr     , Gll^Ftr     , Gll^Ftr     , Wwt         , Qxe         , Wwt         , Qxe         , Wwt         , Qxu^Bs|     , Wwt         , Qxe         , Wwt         
Gg          , Wwt         , Wwt^Bw|     , Wwt         , Wwt         , Wwt         , Wwt         , Wwt         , Wwt         , Wwt         , Wwt^Bw|     , Wwt         , Qxe         , Qxe         , Qxe         , Qxe         , Qxe         , Qxe         , Gs^Fds      , Qxe         , Gs^Fds      , Qxe         , Qxu^Bs|     , Qxe         , Wwt         , Qxe         
Md          , Gg          , Gg^Bw|      , Ce          , Ce          , Ce          , Ce          , Ce          , Ce          , Ce          , Ce          , Gs^Fds      , Gs^Fds      , Gs^Fds      , Gs^Fds      , Gs^Fds      , Gs^Fds      , Gs^Fds      , Gs^Fds      , Gs^Fds      , Gs^Fds      , Gs^Fds      , Qxu^Bs|     , Gs^Fds      , Gs^Fds      , Gs^Fds      
Md          , Md          , Wwg         , Wwg         , Gg          , Gg          , Gg          , Gll^Ftr     , Gll^Ftr     , Gll^Ftr     , Gg          , Gs^Fds      , Gs^Fds      , Gs^Fds      , Gs^Fds      , Gs^Fds      , Ce          , Ce          , Ce          , Ce          , Ce          , Ce          , Ce          , Ce          , Ce          , Gs^Fds      
Md          , Md          , Gll^Ftr     , Gll^Ftr     , Gg          , Gg          , Gg          , Gll^Ftr     , Gll^Ftr     , Gll^Ftr     , Gll^Ftr     , Gs^Fds      , Gs^Fds      , Gs^Fds      , Gs^Fds      , Gs^Fds      , Ce          , Ce          , Rp          , Rp          , Ea          , Rp          , Rp          , Ce          , Ce          , Gs^Fds      
Md          , Md          , Gll^Ftr     , Gll^Ftr     , Gg          , Rp          , Gg          , Gll^Ftr     , Gll^Ftr     , Gll^Ftr     , Gll^Ftr     , Gll^Ftr     , Gs^Fds      , Rp          , Gs^Fds      , Gs^Fds      , Ce          , Ce          , Rp          , Rp          , Rp          , Rp          , Rp          , Ce          , Ce          , Gg          
Md          , Md          , Gll^Ftr     , Gll^Ftr     , Gll^Ftr     , Gg          , Gll^Ftr     , Gll^Ftr     , Gll^Ftr     , Gll^Ftr     , Gll^Ftr     , Gll^Ftr     , Gs^Fds      , Gs^Fds      , Gs^Fds      , Gs^Fds      , Ce          , Ce          , Rp          , Rp          , Rrc         , Rp          , Rp          , Ce          , Ce          , Gs^Fds      
Md          , Md          , Ea          , Gll^Ftr     , Gll^Ftr     , Gll^Ftr     , Gll^Ftr     , Gll^Ftr     , Gll^Ftr     , Gll^Ftr     , Md          , Gs^Fds      , Gs^Fds      , Gs^Fds      , Gs^Fds      , Gs^Fds      , Ce          , Ce          , Rp          , Rp          , Rp          , Rp          , Rp          , Ce          , Ce          , Gs^Fds      
Md          , Md          , Md          , Md          , Md          , Gll^Ftr     , Wwrg        , Wwrg        , Wwrg        , Md          , Md          , Md          , Md          , Ea          , Md          , Gs^Fds      , Ce          , Ce          , Rp          , Rp          , Ea          , Rp          , Rp          , Ce          , Ce          , Gs^Fds      
Md          , Md          , Md          , Md          , Md          , Md          , Md          , Gll         , Gll         , Gll         , Gll         , Md          , Gll^Fdw     , Md          , Md          , Md          , Wwt         , Ce          , Ce          , Rp          , Rp          , Rp          , Ce          , Ce          , Gs^Fds      , Gs^Fds      
Wwt         , Md          , Md          , Md          , Md          , Md          , Md          , Gll         , Gll         , Gll         , Gll         , Gll         , Gll         , Ea          , Md          , Md          , Wwt^Bw/     , Wwt^Bw/     , Wwt         , Ce          , Ce          , Ce          , Wwt         , Wwt         , Wwt         , Wwt         
Wwt         , Wwt         , Wwt         , Md          , Md          , Md          , Gll         , Gll         , Gll         , Rr          , Gll         , Gll         , Gll         , Gll         , Ce          , Ce          , Wwt         , Wwt         , Wwt         , Wwt         , Wwt         , Wwt^Bw|r    , Wwt         , Wwt         , Wwt         , Wwt         
Wwt         , Wwt         , Wwt         , Wwrg        , Wwrg        , Wwrg        , Gll^Fdw     , Gll         , Gll         , Gll         , Gll         , Gll         , Gll         , Gll         , Md          , Md          , Wwt         , Wwt         , Wwt         , Ce          , Ce          , Ce          , Ce          , Ce          , Rp          , Wwt         
Gll^Ftr     , Wwt         , Wwt         , Wwt         , Wwrg        , Wwrg        , Gll^Fdw     , Gll^Fdw     , Gll^Fdw     , Gll^Fdw     , Gll^Fdw     , Gll         , Gll         , Gll^Fdw     , Wwrg        , Md          , Gs^Fds      , Wwt         , Gll^Ftr     , Ea          , Rp          , Rp          , Rp          , Ea          , Rp          , Rp          
Gll^Ftr     , Wwt         , Wwt         , Wwt         , Gll^Ftr     , Wwrg        , Wwrg        , Wwrg        , Wwrg        , Wwrg        , Wwrg        , Wwrg        , Wwrg        , Wwrg^Bw\    , Rp          , Gll^Ftr     , Gll^Ftr     , Gll^Ftr     , Rp          , Rp          , Rp          , Rp          , Rp          , Rp          , Rp          , Rp          
Gll^Ftr     , Gll^Ftr     , Gll^Ftr     , Wwt         , Gll^Ftr     , Gll^Ftr     , Gll^Ftr     , Gll^Ftr     , Gll^Ftr     , Gll^Ftr     , Gll^Ftr     , Gll^Ftr     , Gll^Ftr     , Gll^Ftr     , Gll^Ftr     , Rp          , Rp          , Rp          , Rp          , Rp          , Rrc         , Rp          , Rp          , Rp          , Rp          , Rp          
Gll^Ftr     , Gll^Ftr     , Gll^Ftr     , Gll^Ftr     , Gll^Ftr     , Gll^Ftr     , Gll^Ftr     , Gll^Ftr     , Gll^Ftr     , Gll^Ftr     , Gll^Ftr     , Gll^Ftr     , Gll^Ftr     , Gll^Ftr     , Gll^Ftr     , Gll^Ftr     , Gll^Ftr     , Rp          , Rp          , Rp          , Rp          , Rp          , Rp          , Rp          , Rp          , Rp          
Gll^Ftr     , Gll^Ftr     , Gll^Ftr     , Gll^Ftr     , Gg          , Gll^Ftr     , Gll^Ftr     , Gll^Ftr     , Gll^Ftr     , Gll^Ftr     , Gll^Ftr     , Gll^Ftr     , Gll^Ftr     , Gll^Ftr     , Gs^Fds      , Gll^Ftr     , Gll^Ftr     , Rp          , Rp          , Rp          , Rp          , Rp          , Rp          , Rp          , Rp          , Rp          
