border_size=1
usage=map

Gg          , Gg          , Gs^Fp       , Gg          , Hh          , Gg          , Wo          , Gg          , Gg          , Gg          , Gg          , Gg          , Gg          , Gg          , Gg          , Gg          , Gg          , Gg          , Gg          , Gg          , Gg          , Gg          , Gg          , Gg          , Gg          , Gg          , Gg          , Gg          , Gg          , Gg          , Gg          , Gg          , Gg          , Gg          , Gg          , Gg          , Rr          , Gg          , Gg          , Gg          , Gg          , Gg          , Gg          , Gg          , Gg          , Gg          
Gg          , Gs^Fp       , Gs^Fp       , Gs^Fp       , Hh          , Mm          , Wo          , Wo          , Gg          , Gg          , Gg          , Gg          , Gg          , Rr          , 8 Rr        , Gg          , Rr          , Gg          , Rr          , Gg          , Rr          , Gg          , Rr          , Gg          , Rr          , Gg          , Rr          , Gg          , Rr          , Gg          , Rr          , Rr          , Rr          , Rr          , Rr          , Rr          , 6 Rr        , Rr          , Rr          , Gg          , Ea          , Ea          , Gg          , Gg          , Gg          , Gg          
Gg          , Gs^Fp       , Gs^Fp       , Gs^Fp       , Hh          , Mm          , Mm          , Wo          , Wo          , Gg          , Gg^Vh       , Gg          , Gg          , Rr          , Rr          , Rr          , Gg          , Rr          , Gg          , Rr          , Gg          , Rr          , Gg          , Rr          , Gg          , Rr          , Gg          , Rr          , Gg          , Rr          , Gg          , Gg          , Gg          , Rr          , Rr          , Gg          , Rr          , Gg          , Rr          , Rr          , Rr          , Gg^Vh       , Gg          , Gs^Fp       , Gg          , Gg          
Gg          , Gs^Fp       , Hh          , Hh          , Mm          , Mm          , Mm          , Hh          , Wo          , Wo          , Wo          , Gg          , Gg          , Gg          , Gg          , Gg          , Gg          , Gg^Vh       , Gg          , Gg          , Gg          , Gg          , Gg          , Gg          , Mm          , Gg          , Mm          , Hh^Fp       , Hh^Fp       , Gg          , Gg          , Gg          , Gg          , Gg          , Gg          , Gg          , Rr          , Gg          , Gg          , Rr          , Gg          , Rr          , Rr          , Rr          , Rr          , Gg          
Gg          , Hh          , Hh          , Mm          , Mm          , Mm          , Mm          , Hh          , Wo          , Wo          , Wo          , Wo          , Hh^Fp       , Gg          , Gg          , Gg^Vh       , Ea          , Ea          , Gg          , Gg          , Gg          , Gg          , Mm          , Mm          , Mm          , Mm          , Mm          , Mm          , Hh^Fp       , Gg          , Gg          , Gg          , Gg          , Gg^Vh       , Gg          , Rr          , Gg          , Gg          , Gg          , Gg^Vh       , Gg          , Gg          , Gg          , Rr          , Gg          , Rr          
Gg          , Hh          , Mm          , Mm          , Mm          , Mm          , Mm          , Hh          , Hh^Fds      , Wo          , Wo          , Wo          , Mm          , Hh^Fp       , Hh^Fp       , Gg          , Gg          , Gg          , Hh^Fp       , Hh^Fp       , Mm          , Hh^Fp       , Mm          , Mm          , Hh^Fp       , Mm          , Mm          , Hh^Fp       , Hh^Fp       , Hh^Fp       , Hh^Fp       , Gg          , Gg          , Gg          , Rr          , Rr          , Gg          , Gg          , Gg          , Gg          , Gg          , Gg          , Gs^Fp       , Gg          , Gg          , Gg          
Gg          , Hh          , Mm          , Mm          , Mm          , Mm          , Hh          , Hh          , Hh^Fds      , Gg          , Gg          , Wo          , Wo          , Mm          , Mm          , Hh^Fp       , Mm          , Hh^Fp       , Mm          , Mm          , Hh^Fp       , Mm          , Hh^Fp       , Hh^Fp       , Hh^Fp       , Mm          , Hh^Fp       , Hh^Fp       , Hh^Fp       , Hh^Fp       , Gs^Fp       , Hh^Fp       , Gs^Fp       , Rr          , Gg^Fet      , Gs^Fp       , Gg^Fet      , Gg          , Gs^Fp       , Gg          , Gg          , Gg          , Gg          , Gs^Fp       , Gg          , Gg          
Gg          , Mm          , Mm          , Mm          , Hh          , Hh          , Hh^Fds      , Mm          , Gs^Fp       , Gs^Fp       , Gg          , Gg          , Chw         , Wo          , Wo          , Mm          , Hh^Fp       , Mm          , Hh^Fp       , Hh^Fp       , Wo          , Wo          , Gg          , Hh^Fp       , Hh^Fp       , Hh^Fp       , Hh^Fp       , Hh^Fp       , Hh^Fp       , Gs^Fp       , Gs^Fp       , Gs^Fp       , Rr          , Rr          , Gs^Fp       , Gg^Fet      , Mm          , Gs^Fp       , Mm          , Gs^Fp       , Gs^Fp       , Gg          , Gg          , Gg          , Gg          , Gg          
Gg          , Mm          , Hh          , Hh          , Hh^Fds      , Hh^Fds      , Gg^Fet      , Gg^Fet      , Gg          , Gg          , Gg          , Gg          , Rr          , Rr          , Chw         , Wo          , Wo          , Hh^Fp       , Wo          , Wo          , Gg          , Gg^Vh       , Gg          , Gg          , Ea          , Gg          , Gg          , Gg          , Gg          , Gg          , Rr          , Rr          , Gg          , Gs^Fp       , Gs^Fp       , Gs^Fp       , Mm          , Mm          , Mm          , Mm          , Gs^Fp       , Gs^Fp       , Gg          , Gg          , Gg          , Gg          
Gg          , Hh          , Hh          , Hh^Fds      , Gg^Fet      , Gg^Fet      , Gs^Fdf      , Gs^Fdf      , Gg          , Gg          , Gg          , Gg          , Rr          , Gg          , Gg          , Wo          , Wo          , Wo          , Wo          , Gg          , Gs^Vht      , Gg          , Rr          , Ea          , Rr          , Gg          , Rr          , Gg          , 5 Rr        , Gg          , Rr          , Gg          , Gg          , Gg          , Gg          , Gs^Fp       , Mm          , Mm          , Mm          , Mm          , Gs^Fp       , Gs^Fp       , Gg          , Gg          , Gg          , Gg          
Gg          , Hh          , Hh          , Gg^Fet      , Gg^Fet      , Gs^Fp       , Gg          , Gg          , Gg          , Gg          , Gg          , Gg          , Rr          , Gg          , Gg          , Gg          , Gg          , Wo          , Wo          , Wo          , Wo          , Chw         , Gg          , Rr          , Gg          , Rr          , Gg          , Rr          , Rr          , Rr          , Gg          , Gg          , Gg^Vh       , Gg          , Gg          , Gs^Fp       , Gs^Fp       , Mm          , Gs^Fp       , Mm          , Gs^Fp       , Hh^Fp       , Hh^Fp       , Gg          , Gg          , Gg          
Gg          , Hh          , Gs^Fp       , Gs^Fp       , Gs^Fp       , Gg          , Gg          , Gg          , Gg^Vh       , Gg          , Gg          , Gg          , Rr          , Gg          , Gg          , Gg^Vh       , Gg          , Gg          , Mm          , Wo          , Wo          , Wo          , Wo          , Gg          , Gg          , Gg          , Gg          , Gg          , Gg          , Rr          , Rr          , Rr          , Rr          , Gg          , Rr          , Gg          , Gg          , Gs^Fp       , Gs^Fp       , Mm          , Mm          , Hh^Fp       , Hh^Fp       , Gg          , Gg          , Gg          
Gg          , Gs^Fp       , Gs^Fp       , Gs^Fp       , Gg          , Gg          , Gg          , Gg          , Gg          , Gg          , Gg          , Gg          , Rr          , Gg          , Gg          , Gg          , Gg          , Gg^Vh       , Gg          , Gg          , Gg          , Wo          , Wo          , Wo          , Wo          , Gg^Vh       , Gg          , Gg          , Gg          , Gg          , Gg          , Gg          , Gg          , Rr          , Rr          , Rr          , Rr          , Gg          , Gs^Fp       , Gg^Fet      , Gg^Fet      , Mm          , Mm          , Hh^Fp       , Gg          , Gg          
Gg          , Gs^Fp       , Gg          , Gg          , Gg          , Gg          , Gg          , Gg          , Gg          , Ea          , Ea          , Gg          , Rr          , 1 Gg        , Gg          , Gg          , Gg          , Gg          , Gg          , Gg          , Gg          , Gg          , Gg^Vh       , Wo          , Wo          , Gg          , Gg          , Gg          , Gg^Vh       , Gg          , Gg          , Gg          , Hh^Fp       , Hh^Fp       , Mm          , Hh^Fp       , Mm          , Rr          , Gg          , Gs^Fp       , Gs^Fp       , Mm          , Mm          , Hh^Fp       , Gg          , Gg          
Gg          , Gs^Fp       , Gg          , Gg          , Gg          , Gg          , Gg          , Gg^Vh       , Gg          , Ea          , Ea          , Gg          , Rr          , Rr          , Gg          , Gg          , Gg          , Gg^Vh       , Gg          , Gg          , Gg          , Gg          , Gg          , Wo          , Wo          , Gg          , Gg          , Gg          , Gg          , Gg          , Hh^Fp       , Hh^Fp       , Mm          , Mm          , Mm          , Mm          , Mm          , Rr          , Rr          , Gs^Fp       , Gs^Fp       , Gs^Fp       , Mm          , Hh^Fp       , Gg          , Gg          
Gg          , Gs^Fp       , Gg          , Gg          , Gs^Fp       , Gg          , Gg          , Gg          , Gg          , Gg          , Gg          , Gg          , Gg          , Rr          , Rr          , Gg          , Gg^Vh       , Gg          , Gg          , Gg          , Gg          , Gg          , Gg          , Wo          , Wo          , Wo          , Wo          , Gg          , Hh^Fp       , Hh^Fp       , Mm          , Mm          , Mm          , Mm          , Mm          , Mm          , Mm          , Mm^Vhh      , Hh^Fp       , Gg^Fet      , Gs^Fp       , Mm          , Mm          , Hh^Fp       , Gg          , Gg          
Gg          , Gg          , Gg          , Gs^Fp       , Gs^Fp       , Gs^Fp       , Gg          , Gg          , Gg          , Gg^Vh       , Gg          , Gg          , Gg          , Gg          , Rr          , Gg          , Gg          , Gg          , Gg          , Gg          , Gg          , Gg          , Gg          , Gg          , Wo          , Wo          , Wo          , Wo          , Wo          , Hh^Fp       , Wo          , Mm          , Mm          , Mm          , Mm          , Mm          , Hh^Fp       , Hh^Fp       , Gg          , Gs^Fp       , Gs^Fp       , Mm          , Mm          , Hh^Fp       , Hh^Fp       , Gg          
Gg          , Gg          , Gg^Fet      , Gs^Fp       , Mm          , Mm          , Mm          , Gg          , Gg          , Gg          , Gg          , Gg          , Gg          , Gg          , Rr          , Rr          , Gg          , Gg          , Gg          , Gg          , Gg          , Gg          , Gg          , Wo          , Gg          , Chw         , Chw         , Wo          , Wo          , Wo          , Wo          , Wo          , Mm          , Mm          , Hh^Fp       , Hh^Fp       , Gg^Vh       , Gg          , Gg          , Rr          , Gs^Fp       , Hh^Fp       , Mm          , Hh^Fp       , Hh^Fp       , Gg          
Gg          , Gs^Fp       , Gs^Fp       , Gs^Fp       , Hh^Fp       , Mm          , Mm          , Hh^Fp       , Gg          , Gg          , Gg          , Gg          , Gg^Wm       , Gg          , Gg          , Rr          , Gg          , Gg          , Gg          , Gg          , Gg          , Gg          , Wo          , Wo          , Gg          , Gg          , Gg          , Gg          , Gg^Vh       , Wo          , Wo          , Wo          , Wo          , Hh^Fp       , Hh^Fp       , Hh^Fp       , Gg          , Gg          , Gg          , Rr          , Rr          , Mm          , Mm          , Mm          , Mm          , Gg          
Gg          , Gg^Fet      , Gg          , Hh^Fp       , Mm          , Mm          , Hh^Fp       , Hh^Fp       , Hh^Fp       , Gg          , Gg          , Gg          , Gg          , Gg          , Gg          , Rr          , Rr          , Gg          , Gg          , Gg          , Gg          , Wo          , Wo          , Gg          , Gg          , Gg          , Gg          , Gg          , Gg          , Gg          , Hh^Fp       , Wo          , Wo          , Wo          , Wo          , Gg          , Gg          , Gg          , Gg          , Rr          , Rr          , Hh^Fp       , Hh^Fp       , Hh^Vhh      , Mm          , Mm          
Gg          , Gg          , Gg          , Hh^Fp       , Hh^Fp       , Mm          , Mm          , Hh^Fp       , Gg^Fet      , Gg^Fet      , Gg^Fet      , Gg          , Gg          , Gg          , Gg          , Rr          , Rr          , Gg          , Wo          , Gg          , Wo          , Wo          , Gg          , Gg          , Gg          , Gg          , Gg          , Gg          , Gg          , Gg          , Hh^Fp       , Hh^Fp       , Mm          , Wo          , Wo          , Wo          , Wo          , Gg          , Gg          , Ww          , Gs^Vh       , Rr          , Rr          , Rr          , Rr          , Mm          
Gg          , Gs^Fp       , Gg          , Gg          , Gg          , Hh^Fp       , Hh^Fp       , Mm          , Mm          , Gg^Fet      , Hh^Fp       , Hh^Fp       , Hh^Fp       , Gg          , Hh^Fp       , Gg          , Wo          , Wo^Bw\      , Wo^Bw\      , Wo          , Gg          , Gg          , Gg          , Gg          , Gg          , Gg          , Gg          , Gg          , Gg          , Gg          , Gs^Fp       , Hh^Fp       , Mm          , Mm          , Mm          , Wo          , Wo          , Wo          , Wo          , Gg          , Gg          , Rr          , Rr          , Ea          , Ea          , Rr          
Gg          , Gs^Fp       , Gs^Fp       , Gg          , Gg          , Gg          , Gs^Fp       , Hh^Fp       , Hh          , Mm          , Mm          , Hh          , Mm          , Hh^Fp       , Hh^Fp       , Wo          , Wo          , Wo          , Gg          , Rr          , Rr          , Gg          , Gg          , Ea          , Ea          , Gg          , Gg          , Gg          , Gg          , Gs^Fp       , Hh^Fp       , Hh^Fp       , Hh^Fp       , Mm          , Mm          , Wo          , Wo          , Wo          , Wo          , Gg^Vh       , Gg          , Gg          , Rr          , Gg          , Gg          , Gg          
Gg          , Gs^Fp       , Gg^Fet      , Gg          , Gg          , Gg          , Gg          , Gs^Fp       , Gs^Fp       , Hh          , Hh          , Mm          , Mm          , Mm          , Mm          , Wo          , Gg          , Gg          , Gg          , Gg          , Rr          , Gg^Vh       , Gg          , Ea          , Gg          , Gg          , Gg          , Gg          , Gg          , Gs^Fp       , Hh^Fp       , Hh^Fp       , Hh^Fp       , Mm          , Mm          , Mm          , Mm          , Wo          , Wo          , Wo          , Gg          , Gg          , Gg          , Rr          , Rr          , Gg          
Gg          , Gg          , Gg          , Gg          , Gg          , Gg          , Gg          , Gg          , Gg          , Gs^Fp       , Gs^Fp       , Mm          , Gs^Fp       , Mm          , Gg^Fet      , Gg          , Gg          , Gg          , Gg          , Gg^Vh       , Gg          , Rr          , Gs^Fp       , Gg          , Gg          , Gg          , Gg          , Gg          , Gg          , Gs^Fp       , Hh^Fp       , Hh^Fp       , Mm          , Mm          , Mm          , Mm          , Mm          , Wo          , Wo          , Wo          , Gg^Vh       , Gg          , Gg          , 4 Gg        , Gg          , Gg          
Gg          , Gg          , Gg          , Gg          , Gg          , Gg^Vh       , Gg          , Gg          , Gg          , Gg          , Gs^Fp       , Gs^Fp       , Gg          , Gg^Fet      , Gg          , Gg          , Gg          , Gg^Vh       , Gg          , Gg          , Gg          , 2 Rr        , Gs^Fp       , Gg          , Gg          , Gg^Vh       , Gg          , Gg          , Gg          , Gs^Fp       , Gs^Fp       , Hh^Fp       , Hh^Fp       , Mm          , Hh^Fp       , Hh^Fp       , Mm          , Wo          , Wo          , Wo          , Wo          , Gg          , Wo          , Rr          , Wo          , Gg          
Wo          , Wo          , Wo          , Gg          , Ea          , Ea          , 7 Gg        , Gg^Vh       , Gg          , Gg          , Gg          , Gs^Fp       , Hh          , Gg          , Hh          , Gg          , Gg          , Gg          , Gg          , Ww          , Gg          , Rr          , Rr          , Gg          , Gg          , Gg          , Gg          , Gg          , Ea          , Gg          , Gs^Fp       , Hh^Fp       , Hh^Fp       , Hh^Fp       , Gs^Fp       , Gs^Fp       , Gs^Fp       , Gs^Fp       , Gg          , Wo          , Wo          , Wo          , Wo          , Wo          , Wo          , Wo          
Wo          , Wo          , Wo          , Gg          , Gg          , Gg          , Rr          , Rr          , Gg^Vh       , Gg          , Hh          , Hh          , Wo          , Hh          , Wo          , Wo          , Wo          , Gg          , Gg^Vh       , Ww          , Gg          , Gg          , Gg          , Rr          , Rr          , Rr          , Rr          , Gg          , Gg^Vh       , Gg          , Gs^Fp       , Gs^Fp       , Gs^Fp       , Gs^Fp       , Gg          , Gs^Fp       , Ea          , Ea          , Gg          , Wo          , Wo          , Wo          , Wo          , Wo          , Wo          , Wo          
Wo          , Wo          , Wo          , Wo          , Gg          , Gg          , Gg          , Gg          , Gg          , Gg          , Wo          , Wo          , Wo          , Wo          , Wo          , Wo          , Wo          , Wo          , Wo          , Gg          , Gg          , Gg          , Gg          , Gg          , Gg^Vh       , Rr          , Gg          , Rr          , Rr          , Ww          , Ww          , Ww          , Rr          , Gg          , Gg          , Gg          , Rr          , Gg^Vh       , 3 Gg        , Gg          , Wo          , Wo          , Wo          , Wo          , Gg          , Gg          
Gg          , Gg          , Wo          , Wo          , Wo          , Gg          , Wo          , Gg          , Wo          , Wo          , Wo          , Wo          , Gg          , Wo          , Gg^Vh       , Wo          , Wo          , Wo          , Wo          , Wo          , Wo          , Wo          , Wo          , Gg          , Wo          , Gg          , Gg          , Gg          , Gg          , Rr          , Gg^Vh       , Gg^Vh       , Gg          , Rr          , Gg          , Rr          , Gg^Vh       , Rr          , Rr          , Gg          , Wo          , Wo          , Wo          , Wo          , Gg          , Gg          
Gg          , Gg          , Gg          , Wo          , Wo          , Wo          , Wo          , Wo          , Wo          , Wo          , Hh          , Gg          , Hh          , Gg          , Gg          , Chw         , Chw         , Wo          , Wo          , Wo          , Wo          , Wo          , Wo          , Wo          , Wo          , Wo          , Wo          , Gg          , Wo          , Gg          , Wo          , Gg          , Wo          , Wo          , Wo          , Wo          , Wo          , Wo          , Wo          , Wo          , Wo          , Wo          , Wo          , Wo          , Gg^Vh       , Gg          
Gg          , Gg          , Gg          , Gg          , Gg          , Wo          , Gg          , Wo          , Gs^Fp       , Hh          , Mm          , Mm          , Mm          , Gg          , Gg          , Gg          , Gg^Vh       , Wo          , Wo          , Gg          , Gg          , Gg          , Gs^Fp       , Wo          , Wo          , Wo          , Wo          , Wo          , Wo          , Wo          , Wo          , Wo          , Wo          , Wo          , Wo          , Wo          , Wo          , Wo          , Wo          , Wo          , Wo          , Wo          , Wo          , Wo          , Gg          , Gg          
Gg          , Gg          , Gg          , Gg          , Gg^Vh       , Gg          , Gg          , Gg          , Gs^Fp       , Mm          , Gs^Fp       , Mm          , Gg          , Gg          , Gg          , Gg          , Wo          , Wo          , Gg          , Gg          , Gg          , Gs^Fp       , Mm          , Mm          , Gs^Fp       , Gs^Fp       , Gg          , Wo          , Gg          , Wo          , Hh^Fp       , Hh^Fp       , Gg          , Gg          , Gg          , Gg          , Gg          , Gg          , Gg          , Wo          , Gg^Vh       , Wo          , Khw         , Chw         , Gg          , Gg          
Gg          , Gg          , Gg          , Gg          , Gg          , Gg          , Gg          , Gs^Fp       , Gs^Fp       , Gs^Fp       , Gs^Fp       , Gg          , Gg          , Gg          , Gg          , Gg          , Wo          , Gg          , Gg          , Gg          , Gg          , Gg          , Gg          , Gs^Fp       , Gg          , Gg          , Gg          , Gg          , Gg          , Gg          , Gg          , Gg          , Gg          , Gg          , Gg          , Gg          , Gg          , Gg          , Gg          , Gg^Vh       , Gg          , Gg          , Gg          , Khw         , Gg          , Gg          
Gg          , Gg          , Gg          , Gg          , Gg          , Gg          , Gg          , Gg          , Gg          , Gg          , Gg          , Gg          , Gg          , Gg          , Gg          , Gg          , Wo          , Gg          , Gg          , Gg          , Gg          , Gg          , Gg          , Gg          , Gg          , Gg          , Gg          , Gg          , Gg          , Gg          , Gg          , Gg          , Gg          , Gg          , Gg          , Gg          , Gg          , Gg          , Gg          , Gg          , Gg          , Gg          , Gg          , Gg          , Gg          , Gg          
