border_size=1
usage=map

Mm^Xm       , Mm^Xm       , Mm^Xm       , Mm^Xm       , Mm^Xm       , Mm^Xm       , Mm^Xm       , Mm^Xm       , Mm^Xm       , Mm^Xm       , Mm^Xm       , Mm^Xm       , Mm^Xm       , Mm^Xm       , Mm^Xm       , Gg          , Mm^Xm       , Gg          , Mm^Xm       , Mm^Xm       , Mm^Xm       , Gg          , Mm^Xm       , Mm^Xm       , Mm^Xm       , Mm^Xm       , Mm^Xm       , Mm^Xm       , Mm^Xm       , Mm^Xm       , Mm^Xm       , Mm^Xm       , Mm^Xm       , Gg          , Mm^Xm       , Mm^Xm       , Mm^Xm       , Mm^Xm       , Mm^Xm       , Mm^Xm       , Mm^Xm       , Mm^Xm       , Mm^Xm       , Mm^Xm       , Mm^Xm       , Gg          
Mm^Xm       , Mm^Xm       , Mm^Xm       , Mm^Xm       , Mm^Xm       , Mm^Xm       , Mm^Xm       , Md^Xm       , Mm^Xm       , Mm^Xm       , Mm^Xm       , Mm^Xm       , Mm^Xm       , Mm^Xm       , Mm^Xm       , Mm^Xm       , Mm^Xm       , Md^Xm       , Md^Xm       , Mm^Xm       , Mm^Xm       , Mm^Xm       , Mm^Xm       , Mm^Xm       , Mm^Xm       , Mm^Xm       , Mm^Xm       , Mm^Xm       , Mm^Xm       , Mm^Xm       , Mm^Xm       , Mm^Xm       , Md^Xm       , Mm^Xm       , Md^Xm       , Mm^Xm       , Mm^Xm       , Mm^Xm       , Mm^Xm       , Mm^Xm       , Mm^Xm       , Mm^Xm       , Mm^Xm       , Mm^Xm       , Mm^Xm       , Mm^Xm       
Mm^Xm       , Mm^Xm       , Mm^Xm       , Mm^Xm       , Gs^Ft       , Mm^Xm       , Gs^Ft       , Md^Xm       , Md^Xm       , Md^Xm       , Mm          , Mm^Xm       , Gs^Ft       , Mm^Xm       , Gs^Ft       , Mm^Xm       , Mm^Xm       , Md^Xm       , Md^Xm       , Md^Xm       , Mm^Xm       , Md^Xm       , Md^Xm       , Mm^Xm       , Md^Xm       , Mm^Xm       , Md^Xm       , Md^Xm       , Md^Xm       , Md^Xm       , Md^Xm       , Md^Xm       , Md^Xm       , Md^Xm       , Md^Xm       , Mm^Xm       , Md^Xm       , Mm^Xm       , Mm^Xm       , Mm^Xm       , Mm^Xm       , Mm^Xm       , Mm^Xm       , Mm^Xm       , Mm^Xm       , Mm^Xm       
Mm^Xm       , Mm^Xm       , Mm^Xm       , Mm^Xm       , Gll^Fp      , Gll^Fp      , Gs^Ft       , Md^Xm       , Md^Xm       , Md^Xm       , Ea          , Gs          , Gs^Ft       , Gs^Ft       , Gs^Ft       , Gs^Ft       , Gs          , Gs^Gvs      , Gs^Gvs      , Md^Xm       , Md^Xm       , Md^Xm       , Md^Xm       , Md^Xm       , Gs^Ft       , Md^Xm       , Md^Xm       , Md^Xm       , Md^Xm       , Md^Xm       , Md^Xm       , Md^Xm       , Md^Xm       , Md^Xm       , Gs^Ft       , Md^Xm       , Md^Xm       , Md^Xm       , Mm^Xm       , Mm^Xm       , Mm^Xm       , Mm^Xm       , Mm^Xm       , Mm^Xm       , Mm^Xm       , Mm^Xm       
Mm^Xm       , Mm^Xm       , Mm^Xm       , Mm^Xm       , Gll^Fp      , Gs^Ft       , Gs^Ft       , Gs^Ft       , Gs^Ft       , Md^Xm       , Gs^Ft       , Gs^Ft       , Gs^Ft       , Gs^Ft       , Rr          , Gs^Ft       , Gs^Ft       , Gs^Gvs      , Ea          , Mm          , Gs^Ft       , Md^Xm       , Md^Xm       , Gs^Ft       , Gs^Ft       , Md^Xm       , Md^Xm       , Md^Xm       , Md^Xm       , Md^Xm       , Md^Xm       , Md^Xm       , Gs^Ft       , Gs^Ft       , Gs^Ftp      , Gs^Ft       , Md^Xm       , Md^Xm       , Md^Xm       , Mm^Xm       , Mm^Xm       , Mm^Xm       , Mm^Xm       , Mm^Xm       , Mm^Xm       , Mm^Xm       
Mm^Xm       , Mm^Xm       , Mm^Xm       , Mm^Xm       , Mm^Xm       , Gs^Ftp      , Gs^Ft       , Gs^Ft       , Gs^Ft       , Gs^Ft       , Gs^Ft       , Gs^Ft       , Gs^Ft       , Gs^Ft       , Gs^Ft       , Gs^Ft       , Gs^Ft       , Gs^Ftp      , Gs^Ftp      , Mm          , Mm          , Gs^Ft       , Md          , Gs^Ft       , Ss          , Md^Xm       , Md^Xm       , Md^Xm       , Md^Xm       , Md^Xm       , Gs^Ft       , Gs^Ftp      , Gs^Ft       , Hhd         , Hhd         , Gs^Ft       , Md^Xm       , Md^Xm       , Md^Xm       , Md^Xm       , Md^Xm       , Mm^Xm       , Mm^Xm       , Mm^Xm       , Mm^Xm       , Mm^Xm       
Mm^Xm       , Mm^Xm       , Mm^Xm       , Mm^Xm       , Mm^Xm       , Gs^Fds      , Md          , Gs          , Gs^Efm      , Md^Xm       , Md^Xm       , Md^Xm       , Md^Xm       , Gs^Ft       , Ea          , Gs^Ft       , Md^Xm       , Gs^Ftp      , Gs^Ftp      , Gs^Ftp      , Hh          , Mm          , Md          , Md          , Gg^Gvs      , Gg^Gvs      , Ea          , Gg^Emf      , Gs^Ftp      , Md^Xm       , Gs^Ftp      , Gs^Ft       , Gs          , Dd^Ftd      , Gg          , Gs^Ft       , Gg^Efm      , Gg          , Gg^Efm      , Md^Xm       , Md^Xm       , Md^Xm       , Md^Xm       , Mm^Xm       , Mm^Xm       , Mm^Xm       
Mm^Xm       , Mm^Xm       , Mm^Xm       , Mm^Xm       , Ss          , Gs^Fds      , Gll^Ftr     , Md          , Md          , Gs^Efm      , Gs          , Md^Xm       , Md^Xm       , Md^Xm       , Md^Xm       , Md^Xm       , Md^Xm       , Md^Xm       , Gs^Ftp      , Hh          , Md          , Md          , Gg^Edp      , Gg          , Gg          , Gs          , Gg          , Dd^Ftd      , Gs          , Gs^Ftp      , Gs          , Gs          , Gg          , Gg          , Gg^Gvs      , Gg^Efm      , Gg          , Gg^Efm      , Gg          , Gg^Efm      , Gg^Efm      , Gg^Efm      , Md^Xm       , Md^Xm       , Md^Xm       , Mm^Xm       
Mm^Xm       , Mm^Xm       , Mm^Xm       , Gs^Fds      , Gs^Fds      , Gg^Efm      , Gd^Fts      , Md          , Md          , Gs          , Gs^Ft       , Gs^Ft       , Gs^Ft       , Mm          , Md          , Md          , Md          , Md^Xm       , Md^Xm       , Hh          , Hh          , Md          , Mm          , Gg          , Mm          , Gg          , Gs          , Gs          , Sm          , Gs          , Gg          , Gg          , Gg          , Gg          , Gg^Gvs      , Gg^Gvs      , Md^Xm       , Md^Xm       , Gg          , Gg^Efm      , Gg          , Gg^Efm      , Md^Xm       , Md^Xm       , Md^Xm       , Mm^Xm       
Mm^Xm       , Mm^Xm       , Gll^Ftr     , Gs^Fds      , Gg^Efm      , Gd^Fts      , Rp          , Md          , Md          , Gs^Es       , Gg          , Gll^Ftr     , Gll^Ftr     , Gs^Fds      , Gll^Ftr     , Md^Xm       , Md^Xm       , Md          , Md          , Md          , Hh          , Hh          , Hh          , Mm          , Mm          , Mm          , Hh          , Gs          , Gs          , Gs          , Gg          , Gg          , Gg          , Gg^Gvs      , Gg^Gvs      , Ea          , Md^Xm       , Md^Xm       , Md^Xm       , Md^Xm       , Md^Xm       , Md^Xm       , Md^Xm       , Md^Xm       , Md^Xm       , Mm^Xm       
Mm^Xm       , Mm^Xm       , Md^Xm       , Gs^Ftp      , Gg^Efm      , Gd^Fts      , Rp          , Md          , Md          , Gs^Eff      , Gs          , Gg          , Rp          , Rp          , Gs^Fds      , Ea          , Mm^Xm       , Md          , Md          , Md          , Mm          , Hh          , Hh          , Mm          , Hh          , Hh          , Mm          , Gg          , Rp          , Gg          , Gg          , Gg          , Gg          , Gg          , Md^Xm       , Md^Xm       , Md^Xm       , Md^Xm       , Md^Xm       , Md^Xm       , Md^Xm       , Md^Xm       , Md^Xm       , Md^Xm       , Md^Xm       , Mm^Xm       
Mm^Xm       , Mm^Xm       , Md^Xm       , Md^Xm       , Ss^Efm      , Gg^Efm      , Rp          , Ea          , Gg          , Gs          , Sm          , Gs          , Gg          , Gg          , Gd          , Gs^Fds      , Mm^Xm       , Md          , Md          , Mm          , Mm          , Mm          , Hh          , Hh          , Mm          , Hh          , Hh          , Mm          , Gg          , Rp          , Gg          , Gg          , Md^Xm       , Md^Xm       , Md^Xm       , Md^Xm       , Md^Xm       , Md^Xm       , Md          , Md          , Md          , Md^Xm       , Md^Xm       , Md^Xm       , Md^Xm       , Mm^Xm       
Mm^Xm       , Mm^Xm       , Md^Xm       , Md^Xm       , Gs^Fds      , Gs^Fds      , Gs^Fds      , Rp          , Rr          , Gs          , Gs          , Gs          , Mm          , Mm          , Mm          , Gs^Fds      , Mm          , Md          , Md^Xm       , Mm          , Gg^Efm      , Mm          , Hh          , Mm          , Mm          , Mm          , Mm          , Mm          , Mm          , Rp          , Rp          , Gg          , Gg          , Md^Xm       , Md^Xm       , Md^Xm       , Md^Xm       , Md^Xm       , Gg^Fet      , Md          , Md          , Md          , Md          , Md^Xm       , Md^Xm       , Mm^Xm       
Mm^Xm       , Mm^Xm       , Md^Xm       , Md^Xm       , Md^Xm       , Gg^Efm      , Gg^Efm      , Gd^Fts      , Gd^Es       , Rp          , Rr          , Mm          , Rp          , Mm          , Mm          , Mm          , Md^Xm       , Md^Xm       , Md^Xm       , Gg^Efm      , Gg          , Gg          , Mm^Xm       , Gg^Gvs      , Gg          , Mm          , Mm          , Mm          , Mm          , Mm          , Gg          , Rp          , Rp          , Gg          , Gd^Fts      , Gd^Fts      , Ke          , Ss          , Gs^Ftp      , Md          , Md          , Md          , Md          , Md^Xm       , Md^Xm       , Mm^Xm       
Mm^Xm       , Mm^Xm       , Md^Xm       , Md^Xm       , Gg^Efm      , Md^Xm       , Md^Xm       , Rd^Es       , Gg^Es       , Gg^Es       , Rr          , Gs          , Gs          , Rp          , Gd          , Ms          , Ms          , Ms          , Md^Xm       , Md^Xm       , Gg^Gvs      , Gg^Gvs      , Gg^Gvs      , Mm^Xm       , Mm^Xm       , Gg          , Gg^Efm      , Gg          , Mm          , Mm          , Gg          , Gg          , Gg          , Rp          , Rp          , Rp          , Gs^Ftp      , Gs^Ftp      , Gs^Ftp      , Md          , Md          , Md          , Md          , Md^Xm       , Md^Xm       , Mm^Xm       
Mm^Xm       , Mm^Xm       , Gg^Efm      , Gg          , Gg^Efm      , Ss          , Ss          , Ea          , Rr          , Rr          , Gg          , Ms          , Mm          , Rp          , Ms          , Ms          , Ms          , Ms          , Ms          , Md^Xm       , Md^Xm       , Md^Xm       , Gs          , Gg          , Md^Xm       , Mm^Xm       , Gg^Efm      , Mm          , Rp          , Gg          , Gg          , Re^Eff      , Dd^Ftd      , Gg          , Gg          , Gs^Fms      , Md          , Gs^Ftp      , Md          , Md          , Md          , Md          , Md          , Mm^Xm       , Md^Xm       , Mm^Xm       
Mm^Xm       , Mm^Xm       , Mm^Xm       , Gg^Efm      , Ss          , Ss          , Ss          , Ss          , Gg          , Gg^Efm      , Ms          , Ms          , Mm          , Rp          , Rp          , Gs          , Gs          , Ms          , Gg^Gvs      , Md^Xm       , Gs          , Gs          , Md^Xm       , Md^Xm       , Md^Xm       , Md^Xm       , Mm          , Mm          , Gg          , Gs^Ftp      , Gs^Fms      , Gg          , Gg          , Gg          , Gg          , Gs^Fms      , Md          , Md          , Md          , Md          , Md          , Md          , Md          , Md          , Mm^Xm       , Mm^Xm       
Mm^Xm       , Mm^Xm       , Mm^Xm       , Md          , Md          , Md          , Md          , Md          , Md          , Md          , Md          , Ms          , Mm          , Mm          , Mm          , Re          , Rp          , Gd          , Gg          , Gll^Fp      , Gll^Fp      , Gs^Ftp      , Gs^Ftp      , Md^Xm       , Rp          , Hh          , Mm          , Mm          , Mm          , Gs^Ft       , Gg          , Gs^Ft       , Wog         , Wog         , Ww^Ewl      , Md          , Md          , Md          , Md          , Md          , Md          , Md          , Md          , Md          , Mm^Xm       , Mm^Xm       
Mm^Xm       , Mm^Xm       , Md          , Md          , Md          , Md          , Md          , Md          , Md          , Md          , Md          , Md          , Gg^Es       , Gs          , Gs          , Gs          , Rp          , Gg          , Gg          , Gd          , Rp          , Gd          , Rp          , Rp          , Gg          , Mm          , Gg          , Mm          , Rp          , Gg          , Wog         , Wog         , Wog         , Wog         , Md          , Md          , Md          , Md          , Gs^Fds      , Md          , Md          , Md          , Md          , Mm^Xm       , Mm^Xm       , Mm^Xm       
Mm^Xm       , Mm^Xm       , Mm^Xm       , Md          , Md          , Md          , Md          , Md          , Md          , Md          , Md          , Md          , Md          , Md          , Md          , Gg          , Gs          , Gs          , Gs          , Rp          , Gd          , Gg          , Hh          , Ea          , Md          , Md          , Md          , Gg          , Gd          , Rp          , Wog         , Wog         , Wog         , Wog         , Md          , Md          , Gs^Fds      , Gs^Fds      , Md          , Md          , Md          , Md          , Md          , Mm^Xm       , Mm^Xm       , Mm^Xm       
Mm^Xm       , Mm^Xm       , Mm^Xm       , Mm^Xm       , Md          , Md          , Md          , Md          , Md          , Md          , Md          , Gg          , Gg^Efm      , Gg          , Md          , Md          , Gs          , Sm          , Gs          , Gg          , Hh          , Hh          , Md          , Md          , Md          , Md          , Md          , Gg^Efm      , Gg^Efm      , Rp          , Rp          , Wog         , Wog         , Wog         , Md          , Gs^Ftp      , Gs^Ftp      , Gs^Fds      , Md          , Md          , Md          , Md          , Gs^Fds      , Mm^Xm       , Mm^Xm       , Mm^Xm       
Mm^Xm       , Mm^Xm       , Md          , Md          , Md          , Md          , Md          , Md          , Md          , Md          , Gg^Es       , Gg          , Gg^Efm      , Gg^Gvs      , Gg^Gvs      , Md          , Md          , Gs          , Gg          , Gd          , Hh          , Hh          , Md          , Md          , Md          , Md          , Md^Xm       , Md^Xm       , Gg^Efm      , Re          , Rp          , Wog         , Wog         , Wog         , Wog         , Ww^Ewf      , Gll^Edp     , Gs^Edp      , Mm^Xm       , Md          , Mm^Xm       , Gs^Fds      , Mm^Xm       , Mm^Xm       , Mm^Xm       , Mm^Xm       
Mm^Xm       , Mm^Xm       , Md          , Md          , Md          , Md          , Md          , Md          , Md          , Ss          , Ss^Efm      , Gg          , Gg^Efm      , Gg^Gvs      , Gg^Gvs      , Gg^Gvs      , Gd          , Gg          , Gd          , Gg          , Hh          , Hh          , Md          , Md          , Md          , Md          , Wog         , Md^Xm       , Wog         , Ww^Ewl      , Wog         , Wog         , Wog         , Wog         , Wog         , Wog         , Gll^Fp      , Mm^Xm       , Mm^Xm       , Mm^Xm       , Mm^Xm       , Mm^Xm       , Mm^Xm       , Mm^Xm       , Mm^Xm       , Mm^Xm       
Mm^Xm       , Mm^Xm       , Mm^Xm       , Mm^Xm       , Md          , Md          , Md          , Md          , Md          , Ss          , Ss          , Gs^Efm      , Gg          , Ea          , Gg^Es       , Gg^Es       , Gg          , Gg          , Gg          , Hh          , Hh          , Hh          , Md          , Md          , Md          , Wog         , Wog         , Wog         , Wog         , Wog         , Wog         , Wog         , Wog         , Ww^Ewf      , Ww^Ewf      , Wog         , Gs^Fms      , Gs^Fms      , Gs^Fms      , Mm^Xm       , Mm^Xm       , Mm^Xm       , Mm^Xm       , Mm^Xm       , Mm^Xm       , Mm^Xm       
Mm^Xm       , Mm^Xm       , Mm^Xm       , Mm^Xm       , Md          , Md          , Ss          , Md          , Md          , Md          , Ss          , Gs          , Gs^Efm      , Gs^Efm      , Gs^Efm      , Gg          , Gg^Efm      , Gg^Efm      , Gg^Efm      , Gg          , Gg^Efm      , Hh          , Hh          , Md          , Wwf         , Wwf         , Wwf         , Wog         , Wog         , Wog         , Wog         , Wog         , Gg^Emf      , Rp          , Rp          , Gs^Fms      , Gs^Fms      , Gs^Fms      , Gs^Fms      , Gs^Fms      , Gs^Fms      , Mm^Xm       , Mm^Xm       , Mm^Xm       , Mm^Xm       , Mm^Xm       
Mm^Xm       , Mm^Xm       , Mm^Xm       , Md          , Md          , Ss          , Ss          , Ss          , Ss          , Ss          , Ss          , Gg^Efm      , Ss          , Ss          , Ss          , Gg          , Md          , Md          , Gg^Efm      , Gg          , Gg          , Gg^Gvs      , Gg^Gvs      , Wwrg        , Wwrg        , Ww^Ewf      , Ww^Ewl      , Wwf         , Wog         , Wog         , Wog         , Wog         , Ea          , Gg^Eff      , Rp          , Gg          , Gg          , Gs^Fms      , Ea          , Gs^Fms      , Gs^Fms      , Gs^Fms      , Md          , Mm^Xm       , Mm^Xm       , Mm^Xm       
Mm^Xm       , Mm^Xm       , Mm^Xm       , Md          , Md          , Ss          , Ss          , Ss          , Ss          , Ss          , Ss          , Ss          , Ss          , Ss          , Md          , Md          , Md          , Md          , Md          , Gg^Efm      , Gg          , Gg^Gvs      , Gg^Gvs      , Ea          , Md          , Ww^Ewf      , Md^Xm       , Wwf         , Md^Xm       , Wog         , Wog         , Gs^Fds      , Gs^Fds      , Gs^Fds      , Gs^Fds      , Rp          , Rp          , Gg          , Gg          , Gs^Fms      , Gs^Fms      , Md          , Md          , Mm^Xm       , Mm^Xm       , Mm^Xm       
Mm^Xm       , Mm^Xm       , Mm^Xm       , Md          , Md          , Ss          , Md          , Ss          , Md          , Ss          , Md          , Md          , Md          , Md          , Md          , Md          , Md          , Md          , Md          , Md          , Md          , Md          , Md          , Md          , Md          , Md          , Md^Xm       , Md^Xm       , Md^Xm       , Wog         , Gs^Fds      , Gs^Fds      , Gs^Fds      , Gs^Fds      , Gs^Fds      , Gg          , Gs          , Gs          , Gs          , Gg          , Gs^Fms      , Md          , Md          , Mm^Xm       , Mm^Xm       , Mm^Xm       
Mm^Xm       , Mm^Xm       , Mm^Xm       , Mm^Xm       , Md          , Md          , Md          , Md          , Md          , Md          , Mm^Xm       , Md          , Md          , Md          , Md          , Md          , Md          , Md          , Md          , Mm^Xm       , Md          , Md          , Md          , Md          , Md          , Md          , Md^Xm       , Md^Xm       , Md^Xm       , Md^Xm       , Gs^Eff      , Gs^Fds      , Gs^Fds      , Gs^Fds      , Gs^Fds      , Gg          , Gs          , Sm          , Gs          , Gg          , Gs^Fds      , Gs^Fms      , Md          , Mm^Xm       , Mm^Xm       , Mm^Xm       
Mm^Xm       , Mm^Xm       , Mm^Xm       , Mm^Xm       , Mm^Xm       , Mm^Xm       , Mm^Xm       , Md          , Mm^Xm       , Mm^Xm       , Mm^Xm       , Mm^Xm       , Md          , Md          , Md          , Md          , Md          , Md          , Mm^Xm       , Mm^Xm       , Mm^Xm       , Md          , Md^Xm       , Md          , Md          , Md^Xm       , Md^Xm       , Md^Xm       , Mm^Xm       , Ke          , Gs^Fms      , Gs^Fds      , Gs^Fds      , Gs^Fds      , Gs^Fds      , Gg          , Gs^Fds      , Gs          , Gs^Fds      , Gg          , Gs^Fds      , Gs^Fms      , Md          , Mm^Xm       , Mm^Xm       , Mm^Xm       
Mm^Xm       , Mm^Xm       , Mm^Xm       , Mm^Xm       , Mm^Xm       , Mm^Xm       , Mm^Xm       , Mm^Xm       , Mm^Xm       , Mm^Xm       , Mm^Xm       , Mm^Xm       , Mm^Xm       , Md          , Mm^Xm       , Mm          , Mm^Xm       , Mm^Xm       , Mm^Xm       , Mm^Xm       , Mm^Xm       , Md^Xm       , Md^Xm       , Md^Xm       , Md          , Md^Xm       , Md^Xm       , Md^Xm       , Md^Xm       , Mm^Xm       , Md          , Md          , Md          , Gg          , Md          , Gs^Fds      , Gs^Fds      , Gs^Fds      , Md          , Md          , Md          , Md          , Md          , Mm^Xm       , Mm^Xm       , Mm^Xm       
Mm^Xm       , Mm^Xm       , Mm^Xm       , Mm^Xm       , Mm^Xm       , Mm^Xm       , Mm^Xm       , Mm^Xm       , Mm^Xm       , Mm^Xm       , Mm^Xm       , Mm^Xm       , Mm^Xm       , Mm^Xm       , Mm^Xm       , Mm^Xm       , Md^Xm       , Mm^Xm       , Md^Xm       , Md^Xm       , Md^Xm       , Md^Xm       , Md^Xm       , Md^Xm       , Md^Xm       , Md          , Md          , Md          , Md          , Md          , Md          , Md          , Mm^Xm       , Md          , Md          , Md          , Md          , Md          , Md          , Md          , Md          , Md          , Mm^Xm       , Md          , Mm^Xm       , Mm^Xm       
Mm^Xm       , Mm^Xm       , Mm^Xm       , Mm^Xm       , Mm^Xm       , Mm^Xm       , Mm^Xm       , Mm^Xm       , Mm^Xm       , Mm^Xm       , Mm^Xm       , Mm^Xm       , Md^Xm       , Mm^Xm       , Md^Xm       , Md^Xm       , Md^Xm       , Md^Xm       , Md^Xm       , Md^Xm       , Md^Xm       , Md^Xm       , Md^Xm       , Md^Xm       , Md^Xm       , Md^Xm       , Md^Xm       , Md^Xm       , Md^Xm       , Mm^Xm       , Mm^Xm       , Mm^Xm       , Mm^Xm       , Mm^Xm       , Mm^Xm       , Md          , Mm^Xm       , Mm^Xm       , Mm^Xm       , Mm^Xm       , Mm^Xm       , Mm^Xm       , Mm^Xm       , Mm^Xm       , Mm^Xm       , Mm^Xm       
Mm^Xm       , Mm^Xm       , Mm^Xm       , Mm^Xm       , Mm^Xm       , Mm^Xm       , Mm^Xm       , Mm^Xm       , Mm^Xm       , Mm^Xm       , Mm^Xm       , Mm^Xm       , Mm^Xm       , Md^Xm       , Mm^Xm       , Md^Xm       , Mm^Xm       , Md^Xm       , Md^Xm       , Md^Xm       , Mm^Xm       , Md^Xm       , Mm^Xm       , Md^Xm       , Mm^Xm       , Md^Xm       , Mm^Xm       , Md^Xm       , Mm^Xm       , Mm^Xm       , Mm^Xm       , Mm^Xm       , Mm^Xm       , Mm^Xm       , Mm^Xm       , Mm^Xm       , Mm^Xm       , Mm^Xm       , Mm^Xm       , Mm^Xm       , Mm^Xm       , Mm^Xm       , Mm^Xm       , Mm^Xm       , Mm^Xm       , Mm^Xm       
Mm^Xm       , Mm^Xm       , Mm^Xm       , Mm^Xm       , Mm^Xm       , Mm^Xm       , Mm^Xm       , Mm^Xm       , Mm^Xm       , Mm^Xm       , Gg          , Mm^Xm       , Gg          , Mm^Xm       , Mm^Xm       , Mm^Xm       , Mm^Xm       , Md^Xm       , Mm^Xm       , Mm^Xm       , Mm^Xm       , Mm^Xm       , Mm^Xm       , Mm^Xm       , Mm^Xm       , Mm^Xm       , Mm^Xm       , Mm^Xm       , Mm^Xm       , Mm^Xm       , Mm^Xm       , Mm^Xm       , Mm^Xm       , Mm^Xm       , Mm^Xm       , Mm^Xm       , Mm^Xm       , Mm^Xm       , Mm^Xm       , Mm^Xm       , Mm^Xm       , Mm^Xm       , Mm^Xm       , Mm^Xm       , Mm^Xm       , Mm^Xm       
