border_size=1
usage=map

Ww          , Mm^Xm       , Mm^Xm       , Mm^Xm       , Mm^Xm       , Gg          , Mm^Xm       , Md          , Mm^Xm       , Gg          , Md          , Gg          , Gg          , Gg          , Mm^Xm       , Gg          , Mm^Xm       , Gg          , Mm^Xm       , Gg          , Mm^Xm       , Mm^Xm       , Mm^Xm       , Gg          , Gll^Fmf     , Gll^Fmf     , Gll^Fmf     , Mm^Xm       , Gll^Fmf     , Mm^Xm       , Gll^Fmf     , Gll^Fmf     , Gll^Fmf     , Gll^Fmf     , Gll^Fmf     , Gll^Fmf     , Gll^Fmf     , Mm^Xm       , Mm^Xm       , Mm^Xm       , Mm^Xm       , Mm^Xm       , Mm^Xm       , Mm^Xm       , Mm^Xm       , Mm^Xm       
Ww          , Ww          , Gll^Ftr     , Mm^Xm       , Mm^Xm       , Mm^Xm       , Gll^Ftr     , Mm^Xm       , Gll^Ftr     , Mm^Xm       , Mm^Xm       , Mm^Xm       , Mm^Xm       , Mm^Xm       , Gg          , Mm^Xm       , Mm^Xm       , Mm^Xm       , Mm^Xm       , Mm^Xm       , Mm^Xm       , Mm^Xm       , Mm^Xm       , Mm^Xm       , Gll^Ftr     , Gs          , Gs^Efm      , Gll^Fmf     , Gs^Efm      , Gg^Efm      , Gg^Efm      , Gs^Efm      , Gg          , Gg          , Gg          , Gll^Fmf     , Gll^Fmf     , Gll^Fmf     , Gll^Fmf     , Gll^Fmf     , Gll^Fmf     , Mm^Xm       , Mm^Xm       , Mm^Xm       , Mm^Xm       , Mm^Xm       
Ww          , Ww          , Ww          , Gll^Ftr     , Gs          , Gll^Ftr     , Gll^Ftr     , Gll^Ftr     , Gll^Ftr     , Gll^Ftr     , Gll^Ftr     , Mm^Xm       , Gll^Ftr     , Mm^Xm       , Gll^Ftr     , Gll^Ftr     , Gg          , Mm^Xm       , Mm^Xm       , Mm^Xm       , Mm^Xm       , Mm^Xm       , Mm^Xm       , Gll^Ftr     , Gs          , Gs^Efm      , Gs^Efm      , Gg          , Gs          , Gg          , Rrc         , Rrc         , Rrc         , Gg          , Gs          , Gg          , Gs^Efm      , Gg^Efm      , Gg^Efm      , Gg^Efm      , Gll^Fmf     , Gll^Fdf     , Mm^Xm       , Mm^Xm       , Mm^Xm       , Gg          
Ww          , Ww          , Ww          , Gs          , Gs          , Gs          , Gs          , Gll^Ftr     , Gll^Ftr     , Gg          , Gll^Ftr     , Gll^Ftr     , Gll^Ftr     , Gll^Ftr     , Gll^Ftr     , Gll^Ftr     , Mm^Xm       , Mm^Xm       , Mm^Xm       , Mm^Xm       , Gll^Ftr     , Mm^Xm       , Mm^Xm       , Gll^Ftr     , Gll^Ftr     , Gd^Efm      , Gs^Efm      , Gs          , Gs          , Gg          , Rrc         , Rrc         , Rrc         , Gg          , Gg          , Gs^Efm      , Gs^Efm      , Gg^Efm      , Gg^Efm      , Gg^Es       , Gll^Ftr     , Gll^Fmf     , Gll^Fmf     , Mm^Xm       , Mm^Xm       , Gg          
Ww          , Ww          , Ww          , Ww          , Wwt         , Gs          , Gs          , Gs          , Gs          , Gll^Ftr     , Gs          , Gll^Ftr     , Gs          , Gll^Ftr     , Gll^Ftr     , Gll^Ftr     , Gll^Ftr     , Mm^Xm       , Gll^Ftr     , Gll^Ftr     , Gll^Ftr     , Gll^Ftr     , Gll^Ftr     , Gll^Ftr     , Gs^Efm      , Gs^Efm      , Gs^Efm      , Gg^Efm      , Gs^Efm      , Gg          , Gg          , Rrc         , Gg          , Gg          , Gs          , Gs          , Gs          , Gs^Efm      , Gs^Efm      , Gg          , Gll^Ftr     , Gll^Fmf     , Gll^Fdf     , Mm^Xm       , Mm^Xm       , Mm^Xm       
Wwt         , Ww          , Ww          , Ww          , Ww          , Ww          , Ww          , Wwt         , Wwt         , Gs^Eff      , Gs^Eff      , Gs^Eff      , Gs^Eff      , Gs          , Gs^Gvs      , Gs          , Gs          , Gs          , Gs          , Gs          , Gs          , Gs          , Gs          , Gs          , Gll^Ftr     , Gs          , Gll^Ftr     , Gs          , Gg^Efm      , Gs          , Gg^Efm      , Gg          , Ww^Ewf      , Gg^Efm      , Gll^Ftr     , Gll^Ftr     , Gll^Ftr     , Gs          , Gll^Ftr     , Gll^Ftr     , Gll^Ftr     , Gll^Ftr     , Mm^Xm       , Mm^Xm       , Mm^Xm       , Mm^Xm       
Gs^Fms      , Wwrg        , Wwrg        , Ww          , Wwrg        , Ww          , Ww          , Ww          , Wwt         , Wwt         , Wwt         , Gs^Gvs      , Gs^Vc       , Gs^Gvs      , Wwt         , Wwt         , Wwt         , Wwt         , Wwt         , Gll^Ftr     , Gll^Ftr     , Gll^Ftr     , Gll^Ftr     , Gll^Ftr     , Gll^Ftr     , Gll^Ftr     , Wwt         , Gll^Ftr     , Ww^Efm      , Gg^Efm      , Ww^Ewl      , Ww^Ewf      , Ww^Ewf      , Wwt         , Wwt         , Gll^Ftr     , Gll^Ftr     , Gll^Ftr     , Wwt         , Gll^Ftr     , Gll^Ftr     , Gll^Fmf     , Gll^Fmf     , Mm^Xm       , Mm^Xm       , Mm^Xm       
Gs^Fms      , Gs^Fms      , Gs^Fms      , Gs^Fms      , Gs^Fms      , Gs^Fms      , Wwrg        , Ww          , Ww          , Wwt         , Wwt         , Wwt         , Wwt         , Wwt         , Wwt         , Wwt         , Wwt         , Wwt         , Wwt         , Wwt         , Wwt         , Gll^Ftr     , Gll^Ftr     , Gll^Ftr     , Wwt         , Wwt         , Wwt         , Wwt         , Wwt         , Ww^Ewl      , Ww^Ewf      , Ww^Ewl      , Wwt         , Wwt         , Wwt         , Wwt         , Wwt         , Wwt         , Wwt         , Wwt         , Wwt         , Gll^Fmf     , Wwt         , Mm^Xm       , Mm^Xm       , Mm^Xm       
Gs^Fms      , Gs^Fms      , Gs^Fms      , Gs^Fms      , Gs^Fms      , Gs^Fms      , Gs^Fms      , Ww          , Wwf         , Ww          , Ww          , Wwt         , Wwt         , Wwt         , Wwrg        , Wwt         , Gs^Fds      , Wwt         , Wwt         , Wwt         , Wwt         , Wwt         , Wwt         , Wwt         , Wwt         , Wwt         , Wwt         , Wwt         , Wwt         , Wwt         , Hh          , Wwt         , Wwt         , Wwt         , Wwt         , Wwt         , Wwt         , Wwt         , Wwt         , Wwt         , Wwt         , Wwt         , Wwt         , Mm^Xm       , Mm^Xm       , Mm^Xm       
Gg^Gvs      , Gg^Gvs      , Gg^Gvs      , Gg^Gvs      , Gg          , Gg          , Gg          , Gs^Fms      , Gs^Fms      , Gs^Fms      , Gs^Fms      , Wwrg        , Gs^Fds      , Wwt         , Gs^Fds      , Gs^Fds      , Gs^Fds      , Gs^Ftp      , Mm^Xm       , Mm^Xm       , Mm^Xm       , Wwt         , Wwt         , Wwt         , Wwt         , Wwt         , Mm^Xm       , Mm^Xm       , Hh          , Hh          , Hh          , Hh          , Wwt         , Wwt         , Wwt         , Wwt         , Wwt         , Wwt         , Wwt         , Wwt         , Wwt         , Wwt         , Wwt         , Wwt         , Wwt         , Mm^Xm       
Gg^Gvs      , Gg^Gvs      , Gg          , Gg^Efm      , Gg          , Gg^Efm      , Gg^Efm      , Gg^Efm      , Gg          , Gs^Fms      , Gs^Fms      , Gs^Fms      , Gs^Fms      , Gs^Fds      , Gg          , Gs^Fds      , Mm^Xm       , Mm^Xm       , Mm^Xm       , Mm^Xm       , Mm^Xm       , Mm^Xm       , Mm^Xm       , Wwt         , Mm^Xm       , Mm^Xm       , Mm^Xm       , Mm^Xm       , Mm^Xm       , Mm^Xm       , Mm^Xm       , Hh          , Hh          , Hh          , Hh          , Wwt         , Hh          , Wwt         , Wwt         , Wwt         , Wwt         , Wwt         , Wwt         , Wwt         , Wwt         , Wwt         
Gg^Efm      , Gg^Efm      , Gg^Efm      , Gg^Efm      , Rrc         , Rrc         , Rrc         , Gg^Efm      , Gg^Efm      , Ea          , Gs^Ftp      , Gs^Fms      , Mm^Xm       , Gs^Fms      , Mm^Xm       , Mm^Xm       , Mm^Xm       , Mm^Xm       , Mm^Xm       , Mm^Xm       , Mm^Xm       , Mm^Xm       , Mm^Xm       , Mm^Xm       , Mm^Xm       , Mm^Xm       , Mm^Xm       , Mm^Xm       , Md          , Md          , Md          , Hh          , Hh          , Hh          , Md          , Mm^Xm       , Mm^Xm       , Hh          , Hh          , Hh          , Wwt         , Wwt         , Wwt         , Wwt         , Wwt         , Wwt         
Gg^Efm      , Gg^Efm      , Gg          , Gg^Efm      , Rrc         , Rrc         , Rrc         , Gg^Efm      , Gg^Efm      , Gs^Ftp      , Mm^Xm       , Gs^Fms      , Mm^Xm       , Mm^Xm       , Mm^Xm       , Mm^Xm       , Gs^Ftp      , Mm^Xm       , Gs^Ftp      , Gs^Ftp      , Gs^Ftp      , Mm^Xm       , Mm^Xm       , Mm^Xm       , Mm^Xm       , Mm^Xm       , Mm^Xm       , Mm^Xm       , Hh          , Hh          , Hh          , Hh          , Md          , Md          , Mm^Xm       , Mm^Xm       , Mm^Xm       , Hh          , Hh          , Hh          , Hh          , Wwt         , Wwt         , Wwt         , Wwt         , Wwt         
Gg          , Gg^Efm      , Gg          , Gg^Efm      , Gg^Efm      , Rrc         , Gg^Efm      , Gg^Efm      , Gg          , Gs^Ftp      , Gs^Ftp      , Mm^Xm       , Gs^Ftp      , Mm^Xm       , Gs^Ftp      , Gs^Efm      , Gg^Efm      , Gs^Efm      , Gg^Efm      , Gs^Ftp      , Gg          , Gs^Ftp      , Mm^Xm       , Mm^Xm       , Mm^Xm       , Mm^Xm       , Hh          , Hh          , Hh          , Hh          , Hh          , Md          , Md          , Mm^Xm       , Mm^Xm       , Mm^Xm       , Mm^Xm       , Mm^Xm       , Mm^Xm       , Hh          , Hh          , Hh          , Hh          , Wwt         , Wwt         , Wwt         
Mm^Xm       , Ea          , Mm^Xm       , Gg          , Gg          , Gg^Efm      , Gg          , Gg^Efm      , Gg^Efm      , Gg          , Gg^Efm      , Gs^Ftp      , Gg^Efm      , Gs^Ftp      , Md          , Gg^Efm      , Md          , Gg          , Md          , Mm^Xm       , Gs^Ftp      , Gg^Efm      , Gg          , Mm^Xm       , Mm^Xm       , Hh          , Hh          , Hh          , Hh          , Hh          , Md          , Md          , Mm^Xm       , Mm^Xm       , Mm^Xm       , Mm^Xm       , Mm^Xm       , Mm^Xm       , Mm^Xm       , Hh          , Hh          , Hh          , Md          , Wwt         , Wwt         , Wwt         
Mm^Xm       , Mm^Xm       , Mm^Xm       , Mm^Xm       , Mm^Xm       , Mm^Xm       , Hh          , Gg          , Gg^Efm      , Gg^Efm      , Mm^Xm       , Md          , Md          , Md          , Mm^Xm       , Md          , Mm^Xm       , Md          , Mm^Xm       , Mm^Xm       , Gs^Vc       , Gg          , Gs^Ft       , Gg          , Gs^Ft       , Gs^Ft       , Gs^Ft       , Mm^Xm       , Mm^Xm       , Md          , Md          , Md          , Mm^Xm       , Mm^Xm       , Hh          , Hh          , Hh          , Mm^Xm       , Mm^Xm       , Mm^Xm       , Mm^Xm       , Hh          , Md          , Md          , Md          , Wwt         
Gg          , Mm^Xm       , Mm^Xm       , Mm^Xm       , Hh          , Hh          , Hh          , Hh          , Mm^Xm       , Mm^Xm       , Mm^Xm       , Mm^Xm       , Mm^Xm       , Mm^Xm       , Mm^Xm       , Mm^Xm       , Mm^Xm       , Mm^Xm       , Gs^Ft       , Gs^Ft       , Gs^Ft       , Gs^Ft       , Gs^Ft       , Gs^Ft       , Gs^Ft       , Gs^Ft       , Mm^Xm       , Mm^Xm       , Mm^Xm       , Mm^Xm       , Md          , Md          , Mm^Xm       , Mm^Xm       , Hh          , Hh          , Hh          , Hh          , Hh          , Hh          , Hh          , Hh          , Md          , Md          , Md          , Md          
Md          , Mm^Xm       , Md          , Md          , Hh          , Hh          , Hh          , Mm^Xm       , Mm^Xm       , Mm^Xm       , Gs^Ftp      , Mm^Xm       , Gs^Ft       , Mm^Xm       , Mm^Xm       , Mm^Xm       , Gs^Ft       , Mm^Xm       , Gs^Ft       , Gs^Ft       , Gs^Ft       , Gs^Ft       , Mm^Xm       , Mm^Xm       , Mm^Xm       , Mm^Xm       , Mm^Xm       , Mm^Xm       , Mm^Xm       , Mm^Xm       , Md          , Md          , Md          , Md          , Md          , Hh          , Hh          , Hh          , Hh          , Hh          , Hh          , Hh          , Md          , Md          , Md          , Md          
Md          , Md          , Hh          , Hh          , Hh          , Hh          , Hh          , Hh          , Hh          , Mm^Xm       , Gs^Ftp      , Gs^Ft       , Gs^Ft       , Gs^Ft       , Gs^Ft       , Gs^Ft       , Gs^Ft       , Gs^Ft       , Gs^Ft       , Mm^Xm       , Mm^Xm       , Mm^Xm       , Gs^Ftp      , Mm^Xm       , Mm^Xm       , Mm^Xm       , Gs^Ftp      , Mm^Xm       , Mm^Xm       , Mm^Xm       , Mm^Xm       , Md          , Md          , Md          , Md          , Md          , Md          , Hh          , Md          , Md          , Md          , Md          , Md          , Md          , Md          , Gg          
Md          , Md          , Hh          , Hh          , Md          , Md          , Md          , Hh          , Hh          , Mm^Xm       , Hh          , Gg          , Mm^Xm       , Gs^Ft       , Gs^Ft       , Gs^Ft       , Gs^Ft       , Gs^Ft       , Gs^Ft       , Gs^Ft       , Gs^Ft       , Gs^Ft       , Gs^Ftp      , Gs^Ftp      , Gs^Ftp      , Gs^Ftp      , Gg          , Gs^Ftp      , Mm^Xm       , Mm^Xm       , Mm^Xm       , Md          , Mm^Xm       , Md          , Mm^Xm       , Md          , Md          , Md          , Md          , Md          , Md          , Md          , Md          , Md          , Md          , Hh          
Md          , Md          , Hh          , Hh          , Mm^Xm       , Mm^Xm       , Mm^Xm       , Md          , Mm^Xm       , Hh          , Gs^Ftp      , Gg          , Gs^Ftp      , Mm^Xm       , Mm^Xm       , Mm^Xm       , Mm^Xm       , Gs^Ft       , Mm^Xm       , Mm^Xm       , Gg          , Gg          , Gg          , Gg          , Gg          , Ea          , Gs^Ftp      , Gs^Ftp      , Gs^Ftp      , Mm^Xm       , Mm^Xm       , Mm^Xm       , Hh          , Mm^Xm       , Hh          , Mm^Xm       , Mm^Xm       , Md          , Md          , Md          , Md          , Md          , Md          , Md          , Md          , Gg          
Md          , Md          , Md          , Hh          , Hh          , Hh          , Hh          , Mm^Xm       , Mm^Xm       , Mm^Xm       , Mm^Xm       , Gs^Ftp      , Gg          , Gs^Ftp      , Gs^Ftp      , Mm^Xm       , Mm^Xm       , Mm^Xm       , Mm^Xm       , Mm^Xm       , Gg          , Gg          , Gg          , Gg          , Gg          , Gs^Ftp      , Mm^Xm       , Mm^Xm       , Mm^Xm       , Mm^Xm       , Mm^Xm       , Mm^Xm       , Mm^Xm       , Hh          , Hh          , Gs^Ft       , Gs^Ft       , Gs^Ft       , Gs^Ft       , Md          , Mm^Xm       , Md          , Md          , Md          , Md          , Md          
Mm^Xm       , Md          , Md          , Md          , Md          , Hh          , Hh          , Hh          , Mm^Xm       , Mm^Xm       , Mm^Xm       , Gs^Ftp      , Gs^Ftp      , Gg          , Gg          , Mm^Xm       , Mm^Xm       , Mm^Xm       , Gg          , Gg          , Rrc         , Rrc         , Rrc         , Gg          , Gg          , Gg          , Gs          , Mm^Xm       , Hh          , Mm^Xm       , Mm^Xm       , Mm^Xm       , Mm^Xm       , Hh          , Hh          , Md          , Md          , Gg          , Gg          , Gg          , Gg          , Gs^Ft       , Md          , Md          , Md          , Md          
Md          , Md          , Md          , Md          , Md          , Md          , Md          , Hh          , Mm^Xm       , Mm^Xm       , Mm^Xm       , Mm^Xm       , Gs^Ftp      , Gs^Ftp      , Gs^Ftp      , Gg          , Gg          , Gg          , Gg          , Gg          , Rrc         , Rrc         , Rrc         , Gs          , Gg          , Gg          , Gs          , Hh          , Hh          , Mm^Xm       , Mm^Xm       , Mm^Xm       , Mm^Xm       , Mm^Xm       , Mm^Xm       , Hh          , Md          , Md          , Gs^Ft       , Gg          , Gg          , Gg          , Gs^Ft       , Md          , Md          , Md          
Md          , Md          , Md          , Md          , Md          , Md          , Md          , Md          , Md          , Mm^Xm       , Mm^Xm       , Mm^Xm       , Mm^Xm       , Gs^Ftp      , Gg          , Gs^Ftp      , Gs^Ftp      , Gg          , Gs^Ftp      , Gg          , Gs          , Rrc         , Gs          , Gg          , Gg          , Ea          , Mm^Xm       , Hh          , Hh          , Mm^Xm       , Hh          , Mm^Xm       , Mm^Xm       , Mm^Xm       , Hh          , Hh          , Md          , Md          , Gs^Ft       , Gg          , Gg          , Gg          , Gg          , Gs^Ft       , Md          , Md          
Gs^Ftp      , Gs^Ftp      , Gs^Ftp      , Gs^Ft       , Md          , Md          , Md          , Md          , Mm^Xm       , Mm^Xm       , Mm^Xm       , Mm^Xm       , Mm^Xm       , Mm^Xm       , Mm^Xm       , Mm^Xm       , Mm^Xm       , Gs^Ftp      , Gs^Ftp      , Gg          , Gg          , Gg          , Gg          , Gg          , Gs^Ftp      , Gs^Ftp      , Md          , Md          , Hh          , Hh          , Hh          , Hh          , Hh          , Hh          , Md          , Md          , Mm^Xm       , Mm^Xm       , Gs^Ft       , Gg          , Rrc         , Gg          , Gg          , Ea          , Gs^Ft       , Gg          
Gg          , Gs^Ftp      , Gs^Ftp      , Gs^Ft       , Gs^Ft       , Mm^Xm       , Md          , Md          , Mm^Xm       , Mm^Xm       , Mm^Xm       , Mm^Xm       , Mm^Xm       , Mm^Xm       , Mm^Xm       , Mm^Xm       , Mm^Xm       , Mm^Xm       , Mm^Xm       , Gs^Ftp      , Gs^Ftp      , Gs^Ftp      , Gs^Ftp      , Gs^Ftp      , Mm^Xm       , Mm^Xm       , Md          , Md          , Md          , Hh          , Md          , Hh          , Md          , Md          , Md          , Md          , Mm^Xm       , Gs^Ft       , Gg          , Rrc         , Rrc         , Rrc         , Gg          , Gg          , Gs^Ft       , Gs^Ft       
Gg          , Gs^Ftp      , Gs^Ftp      , Gs^Ftp      , Gs^Ftp      , Gs^Ft       , Gs^Ft       , Gs^Ft       , Gs^Ft       , Gs^Ft       , Gs^Ft       , Mm^Xm       , Gs^Ft       , Mm^Xm       , Gs^Vc       , Mm^Xm       , Gs^Ft       , Mm^Xm       , Gs^Ftp      , Gs^Ftp      , Gs^Ftp      , Gs^Ftp      , Gs^Ftp      , Gs^Ftp      , Mm^Xm       , Mm^Xm       , Mm^Xm       , Mm^Xm       , Mm^Xm       , Md          , Md          , Md          , Mm^Xm       , Md          , Mm^Xm       , Mm^Xm       , Ea          , Gs^Ft       , Gg          , Rrc         , Rrc         , Rrc         , Gg          , Gg          , Ss          , Gs^Ft       
Gg          , Gs^Ftp      , Gs^Ftp      , Gs^Ftp      , Gs^Ftp      , Gs^Ft       , Gs^Ft       , Gs^Ft       , Gs^Ft       , Gs^Ft       , Gs^Ft       , Gs^Ft       , Gs^Ft       , Gs^Ft       , Gs^Ft       , Gs^Ft       , Gs^Ft       , Gs^Ftp      , Gs^Ftp      , Gs^Ftp      , Gs^Ftp      , Gg          , Mm^Xm       , Mm^Xm       , Mm^Xm       , Mm^Xm       , Mm^Xm       , Mm^Xm       , Mm^Xm       , Mm^Xm       , Ss          , Mm^Xm       , Gg          , Mm^Xm       , Ss          , Ss          , Ss          , Ss          , Ss          , Gg          , Gg^Efm      , Gs          , Ss          , Ss          , Wwt         , Ss          
Ss          , Ss          , Ss          , Ss          , Ss          , Gs^Ftp      , Ss          , Ss          , Ss          , Ss          , Ss          , Gs^Ft       , Gs^Ft       , Gs^Ft       , Gs^Ft       , Gs^Ft       , Gs^Ft       , Gs^Ft       , Gs^Ft       , Mm^Xm       , Mm^Xm       , Mm^Xm       , Mm^Xm       , Mm^Xm       , Mm^Xm       , Mm^Xm       , Ss          , Mm^Xm       , Ss          , Ss          , Ss          , Ss          , Ss          , Ss          , Wwt         , Wwt         , Wwt         , Wwt         , Wwt         , Ss          , Wwt         , Wwt         , Wwt         , Wwt         , Wwt         , Wwt         
Gg          , Ss          , Ss          , Ss          , Ss          , Ss          , Ss          , Gg          , Ss          , Ss          , Ss          , Gs^Ft       , Ss          , Ss          , Ss          , Ss          , Ss          , Ss          , Ss          , Gs^Ft       , Gs^Ft       , Gs^Ft       , Ss          , Mm^Xm       , Gs^Ft       , Mm^Xm       , Ss          , Ss          , Wwt         , Wwt         , Wwt         , Wwt         , Wwt         , Wwt         , Wwt         , Wwt         , Wwt         , Wwt         , Wwt         , Wwt         , Wwt         , Wwt         , Wwt         , Wwt         , Wwt         , Wwt         
Ss          , Ss          , Ss          , Ss          , Ss          , Ss          , Ss          , Ss          , Wwt         , Wwt         , Ss          , Ss          , Ss          , Ss          , Wwt         , Ss          , Ss          , Ss          , Wwt         , Ss          , Ss          , Ss          , Ss          , Ss          , Ss          , Ss          , Wwt         , Wwt         , Wwt         , Wwt         , Wwt         , Wwt         , Wwt         , Wwt         , Gg^Efm      , Gg^Efm      , Gg^Efm      , Gg^Efm      , Gg^Efm      , Gg          , Wwt         , Wwt         , Wwt         , Wwt         , Wwt         , Wwt         
Ss          , Ss          , Ss          , Ss          , Ss          , Ss          , Wwt         , Wwt         , Wwt         , Wwt         , Wwt         , Ss          , Wwt         , Wwt         , Wwt         , Ss          , Wwt         , Wwt         , Wwt         , Wwt         , Ss          , Ss          , Wwt         , Wwt         , Wwt         , Wwt         , Wwt         , Wwt         , Wwt         , Wwt         , Gg^Efm      , Gg^Efm      , Gg^Efm      , Gg^Efm      , Gg^Efm      , Gg^Efm      , Wwt         , Gg^Efm      , Wwt         , Wwt         , Wwt         , Wwt         , Wwt         , Wwt         , Wwt         , Wwt         
Gg          , Ss          , Ss          , Ss          , Ss          , Wwt         , Wwt         , Wwt         , Wwt         , Wwt         , Wwt         , Wwt         , Wwt         , Wwt         , Wwt         , Wwt         , Wwt         , Wwt         , Wwt         , Wwt         , Wwt         , Wwt         , Wwt         , Wwt         , Wwt         , Wwt         , Wwt         , Wwt         , Wwt         , Gg^Efm      , Wwt         , Gg^Efm      , Gg^Efm      , Gg^Efm      , Gg^Efm      , Gg^Efm      , Gg^Efm      , Wwt         , Wwt         , Wwt         , Wwt         , Wwt         , Wwt         , Wwt         , Wwt         , Wwt         
Wwt         , Ss          , Gg          , Ss          , Gg          , Wwt         , Wwt         , Wwt         , Wwt         , Wwt         , Gg          , Wwt         , Gg          , Wwt         , Wwt         , Wwt         , Wwt         , Wwt         , Gg          , Wwt         , Gg          , Wwt         , Gg          , Wwt         , Gg          , Wwt         , Gg          , Wwt         , Wwt         , Wwt         , Wwt         , Wwt         , Wwt         , Wwt         , Wwt         , Wwt         , Wwt         , Wwt         , Wwt         , Wwt         , Wwt         , Wwt         , Wwt         , Wwt         , Gg          , Gg          
