border_size=1
usage=map

Mm          , Mm          , Mm          , Mm          , Mm          , Mm          , Gll^Ftr     , Gll^Ftr     , Gll^Ftr     , Gll^Ftr     , Gll^Ftr     , Gll^Ftr     , Gll^Ftr     , Gll^Ftr     , Gll^Ftr     , Gll^Ftr     , Gll^Ftr     , Gll^Ftr     , Gll^Ftr     , Gll^Ftr     , Gll^Ftr     , Gll^Ftr     , Gll^Ftr     , Mm          
Mm          , Mm          , Mm          , Mm          , Mm          , Gll^Ftr     , Gll^Ftr     , Gll^Ftr     , Gll^Ftr     , Gll^Ftr     , Gll^Ftr     , Gll^Ftr     , Gll^Ftr     , Gll^Ftr     , Gll^Ftr     , Gll^Ftr     , Gll^Ftr     , Gg          , Gg          , Gg          , Gg          , Gg          , Gll^Ftr     , Mm          
Mm          , Mm          , Mm          , Mm          , Wog         , Wog         , Wog         , Gll^Ftr     , Gll^Ftr     , Gll^Ftr     , Gll^Ftr     , Gll^Ftr     , Gll^Ftr     , Gll^Ftr     , Gll^Ftr     , Gll^Ftr     , Gg          , Gg          , Gg          , Gg          , Gg          , Gg          , Gg          , Gll^Ftr     
Mm          , Mm          , Mm          , Mm          , Wog         , Wog         , Wog         , Gll^Ftr     , Gll^Ftr     , Gll^Ftr     , Gll^Ftr     , Gll^Ftr     , Gll^Ftr     , Gll^Ftr     , Gll^Ftr     , Gll^Ftr     , Gg          , Gg          , Gg          , Rr          , Gg          , Gg          , Gg          , Gll^Ftr     
Mm          , Mm          , Mm          , Wog         , Wog         , Wog         , Wog         , Wog         , Wog         , Wog         , Wog         , Wo          , Wo          , Gll^Ftr     , Gll^Ftr     , Gll^Ftr     , Gg          , Gg          , Gg          , Gg          , Gg          , Gg          , Gll^Ftr     , Gll^Ftr     
Mm          , Mm          , Ss          , Wog         , Ss          , Ss          , Ss          , Ss          , Ss          , Ss          , Ss          , Wo          , Wo          , Wo          , Gll^Ftr     , Gll^Ftr     , Gll^Ftr     , Gg          , Gg          , Gg          , Gg          , Gg          , Gll^Ftr     , Gll^Ftr     
Ss          , Ss          , Ss          , Ss          , Ss          , Ss          , Ss          , Ss          , Wo          , Ss          , Wo          , Wo          , Wo          , Wo          , Gll^Ftr     , Gll^Ftr     , Gll^Ftr     , Gll^Ftr     , Gll^Ftr     , Gll^Ftr     , Gll^Ftr     , Gll^Ftr     , Gll^Ftr     , Gll^Ftr     
Ss          , Ss          , Ss          , Ss          , Wo          , Wo          , Wo          , Wo          , Wo          , Wo          , Wo          , Wo          , Wo          , Wo          , Wo          , Gll^Ftr     , Gll^Ftr     , Gll^Ftr     , Wo          , Gll^Ftr     , Gll^Ftr     , Gll^Ftr     , Gll^Ftr     , Gll^Ftr     
Ss          , Ss          , Wo          , Wo          , Wo          , Wo          , Wo          , Wo          , Wo          , Wo          , Wo          , Wo          , Wo          , Wo          , Mm          , Wo          , Wo          , Wo          , Gll^Ftr     , Wo          , Gll^Ftr     , Gll^Ftr     , Wog         , Wog         
Wo          , Wo          , Wo          , Wo          , Wo          , Wo          , Wo          , Wo          , Wo          , Wo          , Gll^Ftr     , Wo          , Gll^Ftr     , Wo          , Gll^Ftr     , Gll^Ftr     , Gll^Ftr     , Gll^Ftr     , Gll^Ftr     , Gll^Ftr     , Gll^Ftr     , Wog         , Wog         , Wog         
Ss          , Wo          , Wo          , Wo          , Wo          , Wo          , Wo          , Wo          , Wo          , Wo          , Gll^Ftr     , Gll^Ftr     , Gll^Ftr     , Gll^Ftr     , Gll^Ftr     , Gll^Ftr     , Gll^Ftr     , Gll^Ftr     , Wog         , Wog         , Wog         , Wog         , Wog         , Wog         
Ss          , Wo          , Ss          , Wo          , Wo          , Wo          , Wo          , Wo          , Wo          , Gll^Ftr     , Gll^Ftr     , Gll^Ftr     , Wog         , Gll^Ftr     , Wog         , Gll^Ftr     , Wog         , Wog         , Wog         , Wog         , Wog         , Wog         , Wog         , Wog         
Ss          , Ss          , Ss          , Ss          , Ss          , Wo          , Wo          , Wo          , Wog         , Wog         , Wog         , Wog         , Wog         , Wog         , Wog         , Wog         , Wog         , Wog         , Wog         , Wog         , Wog         , Wog         , Wog         , Wog         
Ss          , Ss          , Ss          , Ss          , Wo          , Wo          , Wo          , Wo          , Wog         , Wog         , Wog         , Wog         , Wog         , Wog         , Wog         , Wog         , Wog         , Wog         , Wog         , Wog         , Md          , Md          , Md          , Md          
Ss          , Ss          , Wo          , Wo          , Wo          , Wo          , Md          , Md          , Hh          , Wog         , Hh          , Wog         , Wog         , Wog         , Wog         , Wog         , Md          , Md          , Md          , Md          , Md          , Md          , Md          , Md          
Md          , Wo          , Wo          , Wo          , Md          , Md          , Md          , Md          , Hh          , Hh          , Hh          , Hh          , Hh          , Hh          , Hh          , Wog         , Md          , Md          , Md          , Md          , Md          , Md          , Md          , Md          
Md          , Md          , Md          , Md          , Md          , Md          , Md          , Hh          , Hh          , Hh          , Hh          , Hh          , Hh          , Hh          , Hh          , Hh          , Hh          , Md          , Md          , Md          , Md          , Md          , Md          , Md          
Md          , Md          , Md          , Md          , Md          , Md          , Md          , Hh          , Hh          , Hh          , Hh          , Hh          , Hh          , Hh          , Hh          , Hh          , Md          , Md          , Md          , Md          , Md          , Md          , Md          , Gg          
Md          , Md          , Md          , Md          , Md          , Md          , Md          , Hh          , Hh          , Hh          , Hh          , Hh          , Hh          , Hh          , Hh          , Hh          , Hh          , Md          , Md          , Md          , Md          , Md          , Md          , Gg          
Md          , Md          , Md          , Md          , Md          , Md          , Md          , Hh          , Hh          , Hh          , Hh          , Hh          , Hh          , Hh          , Md          , Md          , Md          , Hh          , Hh          , Md          , Md          , Md          , Md          , Gg          
Md          , Md          , Md          , Md          , Md          , Md          , Gll^Ftr     , Gll^Ftr     , Gll^Ftr     , Gll^Ftr     , Sm          , Hh          , Hh          , Hh          , Md          , Md          , Md          , Md          , Md          , Gll^Ftr     , Gll^Ftr     , Md          , Md          , Gg          
Md          , Md          , Md          , Md          , Md          , Md          , Gll^Ftr     , Gll^Ftr     , Gll^Ftr     , Gll^Ftr     , Sm          , Gll^Ftr     , Gll^Ftr     , Gll^Ftr     , Gll^Ftr     , Md          , Md          , Md          , Md          , Gll^Ftr     , Gll^Ftr     , Md          , Md          , Gg          
Md          , Md          , Md          , Md          , Md          , Gll^Ftr     , Gll^Ftr     , Gll^Ftr     , Sm          , Sm          , Gll^Ftr     , Gll^Ftr     , Gll^Ftr     , Gll^Ftr     , Md          , Md          , Md          , Md          , Md          , Md          , Sm          , Md          , Md          , Gg          
Md          , Md          , Md          , Md          , Gll^Ftr     , Gll^Ftr     , Gll^Ftr     , Gll^Ftr     , Sm          , Gll^Ftr     , Gll^Ftr     , Gll^Ftr     , Md          , Md          , Md          , Md          , Md          , Md          , Sm          , Sm          , Sm          , Sm          , Md          , Gg          
Gll^Ftr     , Gll^Ftr     , Gll^Ftr     , Gll^Ftr     , Gll^Ftr     , Gll^Ftr     , Gll^Ftr     , Gll^Ftr     , Hh          , Gll^Ftr     , Gll^Ftr     , Gll^Ftr     , Md          , Md          , Md          , Md          , Md          , Md          , Sm          , Sm          , Sm          , Sm          , Md          , Gg          
Gll^Ftr     , Gll^Ftr     , Gll^Ftr     , Gll^Ftr     , Gll^Ftr     , Gll^Ftr     , Sm          , Hh          , Gll^Ftr     , Gll^Ftr     , Md          , Md          , Md          , Md          , Md          , Md          , Md          , Md          , Md          , Sm          , Sm          , Sm          , Md          , Md          
Gll^Ftr     , Gll^Ftr     , Gll^Ftr     , Gll^Ftr     , Hh          , Sm          , Gll^Ftr     , Gll^Ftr     , Gll^Ftr     , Gll^Ftr     , Md          , Md          , Md          , Md          , Md          , Md          , Md          , Md          , Md          , Gll^Ftr     , Md          , Md          , Md          , Md          
Gll^Ftr     , Gll^Ftr     , Gll^Ftr     , Gll^Ftr     , Hh          , Gll^Ftr     , Gll^Ftr     , Gll^Ftr     , Gll^Ftr     , Md          , Md          , Md          , Md          , Md          , Md          , Md          , Ss          , Md          , Ss          , Gll^Ftr     , Md          , Md          , Md          , Md          
Md          , Gll^Ftr     , Md          , Gll^Ftr     , Hh          , Hh          , Rp          , Gll^Ftr     , Gll^Ftr     , Md          , Md          , Md          , Ss          , Md          , Ss          , Ss          , Ss          , Ss          , Ss          , Ss          , Ss          , Md          , Md          , Md          
Md          , Md          , Md          , Md          , Md          , Gll^Ftr     , Gll^Ftr     , Gll^Ftr     , Gll^Ftr     , Md          , Ss          , Ss          , Ss          , Ss          , Ss          , Ss          , Ss          , Ss          , Gll^Ftr     , Ss          , Gll^Ftr     , Ss          , Md          , Md          
Md          , Md          , Md          , Md          , Md          , Md          , Ss          , Gll^Ftr     , Ss          , Ss          , Ss          , Ss          , Ss          , Ss          , Ss          , Ss          , Ss          , Gll^Ftr     , Rr          , Gll^Ftr     , Gll^Ftr     , Gll^Ftr     , Md          , Md          
Md          , Md          , Md          , Md          , Md          , Md          , Md          , Ss          , Ss          , Ss          , Md          , Ss          , Sm          , Sm          , Sm          , Ss          , Ss          , Gll^Ftr     , Gll^Ftr     , Gll^Ftr     , Md          , Hh          , Hh          , Md          
Md          , Md          , Md          , Md          , Md          , Md          , Md          , Md          , Md          , Md          , Md          , Md          , Md          , Md          , Md          , Ss          , Gll^Ftr     , Gll^Ftr     , Md          , Md          , Md          , Md          , Hh          , Md          
Md          , Md          , Md          , Md          , Md          , Md          , Md          , Md          , Md          , Md          , Md          , Md          , Gll^Ftr     , Md          , Gll^Ftr     , Gll^Ftr     , Gll^Ftr     , Md          , Md          , Md          , Mm          , Hh          , Mm          , Mm          
Mm          , Md          , Mm          , Md          , Mm          , Md          , Md          , Md          , Mm          , Md          , Gll^Ftr     , Gll^Ftr     , Gll^Ftr     , Gll^Ftr     , Gll^Ftr     , Gll^Ftr     , Gll^Ftr     , Md          , Mm          , Mm          , Hh          , Hh          , Mm          , Mm          
Mm^Xm       , Mm          , Mm          , Mm          , Mm          , Mm          , Mm          , Mm          , Mm          , Mm          , Mm          , Gll^Ftr     , Gll^Ftr     , Gll^Ftr     , Gll^Ftr     , Gll^Ftr     , Wwg         , Mm          , Mm          , Hh          , Hh          , Hh          , Mm          , Mm          
Mm^Xm       , Mm^Xm       , Mm^Xm       , Mm^Xm       , Mm^Xm       , Mm          , Mm          , Mm          , Mm          , Mm          , Mm          , Gll^Ftr     , Wwg         , Gll^Ftr     , Wwg^Bw|     , Wwg         , Wwg         , Hh          , Hh          , Hh          , Mm          , Mm          , Mm          , Mm          
Mm^Xm       , Mm^Xm       , Mm^Xm       , Mm^Xm       , Mm^Xm       , Mm^Xm       , Mm^Xm       , Mm          , Mm          , Mm          , Mm          , Mm          , Wwg         , Wwg         , Wwg^Bw|     , Wwg         , Wwg         , Hh          , Hh          , Mm          , Mm          , Mm          , Mm          , Mm          
Rrc         , Rrc         , Rrc         , Rrc         , Rrc         , Mm^Xm       , Mm^Xm       , Mm^Xm       , Mm^Xm       , Mm          , Mm          , Ss          , Ss          , Wwg         , Ce          , Wwg         , Wwg         , Hh          , Hh          , Hh          , Hh          , Mm          , Mm          , Mm          
Rrc         , Rrc         , Rrc         , Rrc         , Rrc         , Rrc         , Rrc         , Mm^Xm       , Mm^Xm       , Mm^Xm       , Mm          , Mm          , Ss          , Wwg^Bw/     , Wwg         , Wwg^Bw\     , Wwg^Bw\     , Ss          , Gg          , Hh          , Gg          , Gll^Ftr     , Gll^Ftr     , Gg          
Rrc         , Rrc         , Rrc         , Rrc         , Rrc         , Rrc         , Rrc         , Mm^Xm       , Mm^Xm       , Mm^Xm       , Mm^Xm       , Mm          , Md          , Ss          , Ss          , Ss          , Ss          , Gg          , Gg          , Gg          , Gg          , Gll^Ftr     , Gll^Ftr     , Gll^Ftr     
Rrc         , Rrc         , Rrc         , Rrc         , Rrc         , Rrc         , Rrc         , Rrc         , Mm^Xm       , Mm^Xm       , Mm^Xm       , Mm          , Md          , Md          , Md          , Ss          , Mm          , Gg          , Gg          , Rp          , Gg          , Gll^Ftr     , Gll^Ftr     , Gg          
Rrc         , Rrc         , Rrc         , Rr          , Rrc         , Rrc         , Rrc         , Rrc         , Mm^Xm       , Mm^Xm       , Wo          , Wo          , Ce          , Ss          , Gll^Ftr     , Mm          , Gg          , Gg          , Gg          , Gg          , Gg          , Gll^Ftr     , Gll^Ftr     , Gg          
Rrc         , Rrc         , Rrc         , Rrc         , Rrc         , Rrc         , Rrc         , Mm^Xm       , Mm^Xm       , Mm^Xm       , Wo^Bw/r     , Wo^Bw/r     , Wo          , Wo^Bw\r     , Wo^Bw\r     , Gll^Ftr     , Gll^Ftr     , Gg          , Gll^Ftr     , Gg          , Mm          , Gll^Ftr     , Mm          , Gg          
Rrc         , Rrc         , Rrc         , Rrc         , Rrc         , Rrc         , Mm^Xm       , Mm^Xm       , Mm^Xm       , Ket         , Wo          , Wo          , Wo          , Wo          , Gll^Ftr     , Gll^Ftr     , Mm          , Gll^Ftr     , Mm          , Mm          , Mm          , Mm          , Mm          , Gg          
Rrc         , Rrc         , Rrc         , Rrc         , Rrc         , Rrc         , Mm^Xm       , Mm^Xm       , Wo          , Wo          , Wo          , Wo          , Wo          , Wo          , Mm          , Gll^Ftr     , Mm          , Mm          , Mm          , Mm          , Mm          , Mm          , Mm          , Gg          
Rrc         , Rrc         , Rrc         , Rrc         , Rrc         , Rrc         , Rrc         , Mm^Xm       , Gg          , Wo          , Gg          , Wo          , Gg          , Mm          , Mm          , Mm          , Mm          , Mm          , Mm          , Mm          , Mm          , Mm          , Mm          , Gg          
