border_size=1
usage=map

Hd          , Hd          , Hd          , Hd          , Hd          , Hd          , Hd          , Hd          , Hd          , Hd          , Hd          , Hd          , Hd          , Hd          , Hd          , Hd          , Hd          , Hd          , Hd          , Hd          , Hd          , Hd          , Hd          , Hd          , Hd          , Hd          , Qxe         , Qxe         , Qxe         , Qxe         , Rrc         , Rrc         , Rrc         , Rrc         , Rrc         , Rrc         , Rrc         , Hd          
Hd          , Hd          , Hd          , Hd          , Hd          , Hd          , Hd          , Hd          , Hd          , Hd          , Hd          , Hd          , Hd          , Hd          , Hd          , Hd          , Hd          , Hd          , Hd          , Hd          , Hd          , Hd          , Hd          , Hd          , Hd          , Hd          , Qxe         , Qxe         , Ch          , Qxe         , Rrc         , Rrc         , Rrc         , Rrc         , Rrc         , Rrc         , Rrc         , Rrc         
Hd          , Hd          , Hd          , Hd          , Hd          , Hd          , Hd          , Hd          , Hd          , Hd          , Hd          , Hd          , Hd          , Hd          , Hd          , Hd          , Hd          , Hd          , Hd          , Hd          , Hd          , Hd          , Hd          , Hd          , Hd          , Hd          , Hd          , Ch          , Ch          , Ch          , Rrc         , Rrc         , Rrc         , Rrc         , Rrc         , Rrc         , Rrc         , Rrc         
Hd          , Hd          , Hd          , Hd          , Hd          , Hd          , Hd          , Hd          , Hd          , Hd          , Hd          , Hd          , Hd          , Hd          , Hd          , Hd          , Hd          , Hd          , Hd          , Hd          , Hd          , Hd          , Qxe         , Qxe         , Hd          , Hd          , Qxe         , Ch          , Ch          , Ch          , Rrc         , Rrc         , Rrc         , Rr          , Rrc         , Rrc         , Rrc         , Rrc         
Hd          , Hd          , Hd          , Hd          , Hd          , Hd          , Hd          , Hd          , Hd          , Hd          , Hd          , Hd          , Hd          , Hd          , Hd          , Hd          , Hd          , Hd          , Hd          , Hd          , Hd          , Hd          , Qxe         , Qxe         , Hd          , Hd          , Qxe         , Ch          , Ch          , Ch          , Rrc         , Rrc         , Rrc         , Rrc         , Rrc         , Rrc         , Rrc         , Rrc         
Hd          , Hd          , Hd          , Hd          , Hd          , Hd          , Hd          , Hd          , Hd          , Hd          , Hd          , Hd          , Hd          , Hd          , Hd          , Hd          , Hd          , Hd          , Hd          , Hd          , Hd          , Hd          , Qxe         , Qxe         , Hd          , Hd          , Qxe         , Ch          , Ch          , Ch          , Rrc         , Rrc         , Rrc         , Rrc         , Rrc         , Rrc         , Rrc         , Rrc         
Hd          , Hd          , Hd          , Hd          , Hd          , Hd          , Hd          , Hd          , Hd          , Hd          , Hd          , Hd          , Hd          , Hd          , Hd          , Hd          , Hd          , Hd          , Hd          , Hd          , Hd          , Hd          , Qxe         , Qxe         , Hd          , Hd          , Hd          , Ch          , Ch          , Ch          , Ch          , Ch          , Ch          , Ch          , Ch          , Ch          , Ch          , Ch          
Hd          , Hd          , Hd          , Hd          , Hd          , Hd          , Hd          , Hd          , Hd          , Hd          , Hd          , Hd          , Hd          , Hd          , Hd          , Hd          , Hd          , Hd          , Hd          , Hd          , Hd          , Hd          , Hd          , Qxe         , Hd          , Hd          , Qxe         , Ch          , Ch          , Ch          , Ch          , Ch          , Ch          , Ch          , Ch          , Ch          , Ch          , Ch          
Hd          , Hd          , Hd          , Hd          , Hd          , Hd          , Hd          , Hd          , Hd          , Hd          , Hd          , Hd          , Hd          , Hd          , Hd          , Hd          , Hd          , Hd          , Hd          , Hd          , Hd          , Hd          , Hd          , Hd          , Hd          , Hd          , Qxe         , Ch          , Qxe         , Ea          , Qxe         , Ch          , Qxe         , Ch          , Qxe         , Ea          , Qxe         , Ch          
Hd          , Hd          , Hd          , Hd          , Hd          , Hd          , Hd          , Hd          , Hd          , Hd          , Hd          , Hd          , Hd          , Hd          , Hd          , Hd          , Hd          , Hd          , Hd          , Hd          , Hd          , Hd          , Hd          , Hd          , Hd          , Hd          , Hd          , Qxe         , Qxe         , Qxe         , Qxe         , Qxe         , Qxe         , Qxe         , Qxe         , Qxe         , Qxe         , Qxe         
Hd          , Hd          , Hd          , Hd          , Hd          , Hd          , Hd          , Hd          , Hd          , Hd          , Hd          , Hd          , Hd          , Hd          , Hd          , Hd          , Hd          , Hd          , Hd          , Hd          , Hd          , Hd          , Hd          , Hd          , Hd          , Hd          , Hd          , Hd          , Hd          , Hd          , Hd          , Hd          , Hd          , Hd          , Hd          , Hd          , Hd          , Hd          
Hd          , Hd          , Hd          , Hd          , Hd          , Hd          , Hd          , Hd          , Hd          , Hd          , Hd          , Hd          , Hd          , Hd          , Hd          , Hd          , Hd          , Hd          , Hd          , Hd          , Hd          , Hhd         , Hhd         , Hhd         , Hhd         , Hhd         , Hhd         , Hd          , Hd          , Hd          , Hd          , Hd          , Hd          , Hd          , Hd          , Hd          , Hd          , Hd          
Hd          , Hd          , Hd          , Hd          , Hd          , Hd          , Hd          , Hd          , Hd          , Hd          , Hd          , Hd          , Hd          , Hd          , Hd          , Hd          , Hd          , Hd          , Hd          , Hd          , Hhd         , Hhd         , Hhd         , Hhd         , Hhd         , Hhd         , Hhd         , Hhd         , Hhd         , Hhd         , Hhd         , Hd          , Hd          , Hd          , Hd          , Hd          , Hd          , Hd          
Hd          , Hd          , Hd          , Hd          , Hd          , Hd          , Hd          , Hd          , Hd          , Hd          , Md          , Hd          , Hd          , Hd          , Hd          , Hd          , Md          , Hhd         , Hhd         , Hhd         , Hhd         , Hhd         , Hhd         , Hhd         , Hhd         , Hhd         , Hhd         , Hhd         , Hhd         , Hhd         , Hhd         , Hhd         , Hhd         , Hhd         , Md          , Hd          , Hd          , Hd          
Hd          , Hd          , Hd          , Hd          , Hd          , Hd          , Md          , Md          , Md          , Md          , Md          , Md          , Md          , Hd          , Md          , Md          , Md          , Md          , Md          , Md          , Ce          , Ce          , Ce          , Ce          , Ce          , Ce          , Ce          , Ce          , Ce          , Ce          , Ce          , Md          , Md          , Md          , Md          , Md          , Md          , Md          
Hd          , Hd          , Hd          , Hd          , Hd          , Hd          , Md          , Md          , Md          , Md          , Md          , Md          , Md          , Md          , Md          , Md          , Md          , Md          , Md          , Md          , Ce          , Hh          , Hh          , Hh          , Hh          , Hh          , Hh          , Hh          , Hh          , Hh          , Ce          , Md          , Md          , Md          , Md          , Md          , Md          , Md          
Hd          , Hd          , Md          , Md          , Md          , Hd          , Hd          , Md          , Md          , Md          , Md          , Md          , Md          , Md          , Md          , Md          , Md          , Md          , Md          , Md          , Md          , Hh          , Hh          , Hh          , Hh          , Rp          , Hh          , Hh          , Hh          , Hh          , Ea          , Md          , Md          , Md          , Md          , Md          , Md          , Md          
Hd          , Md          , Md          , Md          , Md          , Md          , Hd          , Hd          , Hd          , Md          , Md          , Md          , Md          , Md          , Md          , Md          , Md          , Md          , Md          , Md          , Md          , Hh          , Hh          , Hh          , Hh          , Hh          , Hh          , Hh          , Hh          , Hh          , Md          , Md          , Md          , Md          , Md          , Md          , Md          , Md          
Hd          , Md          , Md          , Md          , Md          , Md          , Hd          , Md          , Md          , Md          , Md          , Md          , Md          , Md          , Md          , Md          , Md          , Md          , Md          , Md          , Md          , Hh          , Hh          , Hh          , Hh          , Hh          , Hh          , Hh          , Hh          , Md          , Md          , Md          , Md          , Md          , Md          , Md          , Md          , Md          
Hd          , Md          , Md          , Md          , Md          , Md          , Hd          , Md          , Md          , Md          , Md          , Md          , Md          , Md          , Md          , Md          , Md          , Md          , Md          , Md          , Md          , Md          , Ce          , Ce          , Ce          , Ce          , Ce          , Ce          , Ce          , Md          , Md          , Md          , Md          , Md          , Md          , Md          , Md          , Md          
Hd          , Hd          , Hd          , Md          , Md          , Hd          , Md          , Md          , Md          , Md          , Md          , Md          , Md          , Md          , Md          , Md          , Md          , Md          , Md          , Md          , Md          , Md          , Hh          , Ce          , Hh          , Ce          , Hh          , Ce          , Ce          , Md          , Hh          , Hh          , Hh          , Md          , Md          , Md          , Md          , Hh          
Hd          , Hd          , Hd          , Hd          , Hd          , Hd          , Md          , Md          , Md          , Md          , Md          , Md          , Md          , Md          , Md          , Md          , Md          , Md          , Md          , Md          , Md          , Md          , Md          , Hh          , Hh          , Hh          , Hh          , Hh          , Hh          , Hh          , Md          , Md          , Md          , Hh          , Hh          , Hh          , Hh          , Hh          
Hd          , Hd          , Hd          , Hd          , Hd          , Hd          , Hd          , Md          , Md          , Md          , Hd          , Hd          , Hd          , Hd          , Md          , Md          , Md          , Md          , Md          , Md          , Md          , Md          , Md          , Hh          , Hh          , Hh          , Hh          , Md          , Md          , Md          , Md          , Md          , Md          , Hh          , Hh          , Hh          , Hh          , Hh          
Md          , Hd          , Hd          , Hd          , Hd          , Hd          , Hd          , Hd          , Hd          , Hd          , Hd          , Hd          , Md          , Md          , Md          , Md          , Md          , Md          , Md          , Md          , Md          , Md          , Ce          , Ce          , Ce          , Ce          , Ce          , Ce          , Ce          , Ce          , Md          , Md          , Md          , Hh          , Hh          , Hh          , Hh          , Hh          
Md          , Md          , Md          , Hh          , Md          , Hd          , Md          , Hd          , Md          , Md          , Md          , Md          , Md          , Md          , Md          , Md          , Md          , Md          , Md          , Md          , Md          , Md          , Gg          , Gg          , Md          , Md          , Md          , Gg          , Gg          , Ce          , Md          , Md          , Md          , Md          , Md          , Hh          , Hh          , Hh          
Md          , Md          , Md          , Hh          , Hh          , Md          , Md          , Md          , Md          , Md          , Md          , Md          , Md          , Md          , Md          , Md          , Md          , Md          , Md          , Md          , Gll^Ftr     , Gll^Ftr     , Gll^Ftr     , Gll^Ftr     , Md          , Md          , Md          , Gll^Ftr     , Gll^Ftr     , Gll^Ftr     , Md          , Md          , Md          , Md          , Md          , Hh          , Hh          , Hh          
Md          , Md          , Md          , Hh          , Md          , Hh          , Hh          , Md          , Md          , Md          , Md          , Md          , Md          , Md          , Md          , Md          , Md          , Md          , Md          , Md          , Gll^Ftr     , Gll^Ftr     , Gll^Ftr     , Md          , Md          , Md          , Md          , Gll^Ftr     , Gll^Ftr     , Gll^Ftr     , Md          , Md          , Md          , Md          , Md          , Hh          , Hh          , Hh          
Md          , Md          , Md          , Md          , Md          , Md          , Md          , Hh          , Md          , Md          , Md          , Md          , Md          , Mm          , Mm          , Md          , Md          , Md          , Md          , Md          , Gll^Ftr     , Gll^Ftr     , Gll^Ftr     , Md          , Gll^Ftr     , Gll^Ftr     , Gll^Ftr     , Gll^Ftr     , Gll^Ftr     , Gll^Ftr     , Md          , Md          , Md          , Md          , Md          , Hh          , Hh          , Hh          
Md          , Md          , Md          , Md          , Hh          , Md          , Hh          , Hh          , Md          , Md          , Md          , Md          , Md          , Md          , Md          , Md          , Md          , Md          , Md          , Md          , Gll^Ftr     , Gll^Ftr     , Gll^Ftr     , Gll^Ftr     , Gll^Ftr     , Gll^Ftr     , Gll^Ftr     , Gll^Ftr     , Gll^Ftr     , Gll^Ftr     , Md          , Md          , Md          , Md          , Mm^Xm       , Hh          , Hh          , Hh          
Md          , Md          , Hh          , Hh          , Md          , Hh          , Md          , Md          , Md          , Md          , Md          , Md          , Md          , Md          , Md          , Md          , Md          , Md          , Md          , Gll^Ftr     , Gll^Ftr     , Gll^Ftr     , Ms^Xm       , Gll^Ftr     , Gll^Ftr     , Gll^Ftr     , Gll^Ftr     , Gll^Ftr     , Md          , Gll^Ftr     , Mm^Xm       , Mm^Xm       , Mm^Xm       , Mm^Xm       , Mm^Xm       , Mm^Xm       , Mm^Xm       , Mm^Xm       
Md          , Md          , Md          , Hh          , Hh          , Hh          , Hh          , Md          , Md          , Md          , Md          , Md          , Md          , Md          , Md          , Md          , Md          , Md          , Md          , Md          , Mm^Xm       , Mm^Xm       , Mm^Xm       , Mm^Xm       , Md          , Md          , Gll^Ftr     , Gll^Ftr     , Gll^Ftr     , Md          , Md          , Mm^Xm       , Mm^Xm       , Mm^Xm       , Mm^Xm       , Mm^Xm       , Mm^Xm       , Mm^Xm       
Md          , Md          , Md          , Md          , Md          , Md          , Md          , Hh          , Hh          , Md          , Md          , Md          , Md          , Md          , Md          , Md          , Md          , Md          , Mm^Xm       , Mm^Xm       , Mm^Xm       , Mm^Xm       , Md          , Md          , Md          , Md          , Ch          , Gll^Ftr     , Ch          , Ea          , Ch          , Mm^Xm       , Ch          , Mm^Xm       , Mm^Xm       , Mm^Xm       , Mm^Xm       , Mm^Xm       
Md          , Md          , Md          , Md          , Md          , Md          , Hh          , Hh          , Md          , Md          , Md          , Md          , Md          , Md          , Mm^Xm       , Md          , Mm^Xm       , Mm^Xm       , Mm^Xm       , Mm^Xm       , Hh          , Md          , Md          , Md          , Ch          , Ch          , Gg^Gvs      , Ch          , Gg^Gvs      , Ch          , Gg^Gvs      , Ch          , Gg^Gvs      , Ch          , Mm^Xm       , Mm^Xm       , Mm^Xm       , Mm^Xm       
Md          , Md          , Md          , Md          , Hh          , Hh          , Hh          , Hh          , Md          , Md          , Hh          , Md          , Md          , Md          , Mm^Xm       , Mm^Xm       , Hh          , Mm^Xm       , Hh          , Hh          , Hh          , Hh          , Gll^Ftr     , Gll^Ftr     , Ch          , Ch          , Gg^Gvs      , Gg^Gvs      , Gg^Gvs      , Gg^Gvs      , Gg^Gvs      , Gg^Gvs      , Gg^Gvs      , Ch          , Mm^Xm       , Mm^Xm       , Mm^Xm       , Mm^Xm       
Md          , Md          , Hh          , Hh          , Md          , Md          , Md          , Md          , Hh          , Md          , Hh          , Hh          , Hh          , Md          , Hh          , Mm^Xm       , Hh          , Hh          , Hh          , Hh          , Hh          , Hh          , Gll^Ftr     , Gll^Ftr     , Ch          , Ch          , Gg^Gvs      , Gg^Gvs      , Gg^Gvs      , Gg^Gvs      , Gg^Gvs      , Gg^Gvs      , Gg^Gvs      , Ch          , Gll^Ftr     , Mm^Xm       , Gll^Ftr     , Mm^Xm       
Md          , Hh          , Hh          , Md          , Md          , Md          , Md          , Hh          , Hh          , Hh          , Hh          , Ea          , Hh          , Hh          , Hh          , Hh          , Hh          , Hh          , Hh          , Hh          , Md          , Hh          , Md          , Gll^Ftr     , Ch          , Ch          , Gg^Gvs      , Gg^Gvs      , Gg^Gvs      , Rp          , Gg^Gvs      , Gg^Gvs      , Gg^Gvs      , Ch          , Gll^Ftr     , Gll^Ftr     , Gll^Ftr     , Gll^Ftr     
Md          , Hh          , Hh          , Hh          , Hh          , Md          , Hh          , Hh          , Hh          , Hh          , Hh          , Rp          , Hh          , Hh          , Hh          , Hh          , Hh          , Hh          , Md          , Md          , Md          , Md          , Md          , Md          , Ch          , Ch          , Gg^Gvs      , Gg^Gvs      , Gg^Gvs      , Gg^Gvs      , Gg^Gvs      , Gg^Gvs      , Gg^Gvs      , Ch          , Gll^Ftr     , Gll^Ftr     , Gll^Ftr     , Gll^Ftr     
Md          , Md          , Md          , Md          , Md          , Hh          , Md          , Hh          , Hh          , Hh          , Hh          , Hh          , Hh          , Hh          , Hh          , Hh          , Md^Xm       , Md          , Md^Xm       , Md          , Md          , Md          , Md^Xm       , Md          , Md^Xm       , Ch          , Ch          , Ch          , Ch          , Ch          , Ch          , Ch          , Ch          , Ch          , Gll^Ftr     , Gll^Ftr     , Md          , Gll^Ftr     
Md          , Md          , Md          , Md          , Md          , Md          , Md          , Md          , Md          , Hh          , Hh          , Hh          , Gll^Ftr     , Hh          , Gll^Ftr     , Gll^Ftr     , Md          , Md^Xm       , Md^Xm       , Md^Xm       , Md^Xm       , Md^Xm       , Md^Xm       , Md^Xm       , Md^Xm       , Md^Xm       , Md^Xm       , Md^Xm       , Md^Xm       , Md^Xm       , Md^Xm       , Gg          , Md^Xm       , Ea          , Md          , Md          , Md          , Md          
Md          , Md          , Md          , Md          , Md          , Md          , Md          , Md          , Md          , Md          , Gll^Ftr     , Gll^Ftr     , Gll^Ftr     , Hh          , Hh          , Gll^Ftr     , Gll^Ftr     , Md          , Md          , Md          , Md          , Md          , Md          , Md          , Md          , Md          , Md          , Md          , Md          , Md^Xm       , Md^Xm       , Md^Xm       , Md^Xm       , Md^Xm       , Md^Xm       , Md          , Md          , Md          
Md          , Md          , Md          , Md          , Md          , Md          , Md          , Md          , Md          , Md          , Gll^Ftr     , Gll^Ftr     , Gll^Ftr     , Hh          , Ss          , Hh          , Hh          , Hh          , Hh          , Md          , Gll^Ftr     , Md          , Md          , Md          , Ss          , Ss          , Gll^Ftr     , Md          , Md          , Md          , Md          , Md          , Md          , Md^Xm       , Md          , Md          , Md          , Md          
Md          , Md          , Md          , Md          , Md          , Md          , Md          , Md          , Md          , Md          , Md          , Md          , Md          , Ss          , Md          , Ss          , Md          , Gll^Ftr     , Md          , Hh          , Hh          , Hh          , Hh          , Hh          , Hh          , Gll^Ftr     , Gll^Ftr     , Gll^Ftr     , Gll^Ftr     , Gll^Ftr     , Gll^Ftr     , Md          , Md          , Md          , Md          , Md          , Md          , Md          
