border_size=1
usage=map

Wwg         , Wwg         , Wwg         , Wwg         , Wwg         , Wwg         , Wwg         , Wwg         , Wwg         , Wwg         , Wwg         , Wwg         , Wwg         , Wwg         , Wwg         , Wwg         , Wwg         , Wwg         , Wwg         , Wwg         , Wwg         , Gg          , Gll^Ftr     , Gll^Ftr     , Gll^Ftr     , Gll^Ftr     , Gll^Ftr     , Gll^Ftr     , Gll^Ftr     , Gll^Ftr     , Gll^Ftr     , Gll^Ftr     , Gll^Ftr     , Gll^Ftr     , Gll^Ftr     , Gll^Ftr     , Gg          
Wwf         , Wwg         , Wwg         , Wwg         , Gg          , Wwg         , Gg          , Wwg         , Wwg         , Wwg         , Wwg         , Wwg         , Wwg         , Wwg         , Wwg         , Wwg         , Wwg         , Wwg         , Wwg         , Wwg         , Gg          , Wwg         , Gll^Ftr     , Gll^Ftr     , Gg          , Gg          , Gg          , Gg          , Ce          , Gll^Ftr     , Gg          , Gg          , Gg          , Gll^Ftr     , Gll^Ftr     , Gll^Ftr     , Gll^Ftr     
Wwf         , Wwf         , Gll^Ftr     , Gll^Ftr     , Gll^Ftr     , Gll^Ftr     , Gll^Ftr     , Gll^Ftr     , Gg          , Gg          , Gg          , Gll^Ftr     , Gll^Ftr     , Gll^Ftr     , Gll^Ftr     , Gll^Ftr     , Gg          , Gll^Ftr     , Gll^Ftr     , Gll^Ftr     , Gll^Ftr     , Gll^Ftr     , Gll^Ftr     , Gll^Ftr     , Gg          , Gg          , Ce          , Ce          , Gll^Ftr     , Ce          , Ce          , Gg          , Gg          , Gg          , Gll^Ftr     , Gll^Ftr     , Gll^Ftr     
Wwf         , Wwf         , Wwf         , Gll^Ftr     , Gg          , Gg          , Gg          , Gg          , Gg          , Gg          , Gg          , Gg          , Gg          , Gll^Ftr     , Gg          , Gg          , Gg          , Gg          , Gg          , Gll^Ftr     , Gg          , Gll^Ftr     , Gll^Ftr     , Gll^Ftr     , Gg          , Gg          , Ce          , Gll^Ftr     , Rr          , Gll^Ftr     , Ce          , Gg          , Gg          , Gg          , Gll^Ftr     , Gll^Ftr     , Gll^Ftr     
Wwf         , Wwf         , Wwf         , Wwf         , Gg          , Gg          , Gll^Ftr     , Gg          , Gll^Ftr     , Gg          , Gll^Ftr     , Gg          , Gll^Ftr     , Gg          , Gll^Ftr     , Gg          , Gg          , Gg          , Gg          , Gg          , Wwf         , Wwf         , Gll^Ftr     , Gg          , Gg          , Gg          , Ce          , Gll^Ftr     , Gll^Ftr     , Gll^Ftr     , Ce          , Gg          , Gg          , Gg          , Gll^Ftr     , Gll^Ftr     , Gll^Ftr     
Wwf         , Wwf         , Wwf         , Wwf         , Wwf         , Gll^Ftr     , Gll^Ftr     , Gll^Ftr     , Gll^Ftr     , Gll^Ftr     , Gll^Ftr     , Gll^Ftr     , Gll^Ftr     , Gll^Ftr     , Gll^Ftr     , Gll^Ftr     , Gll^Ftr     , Gll^Ftr     , Gll^Ftr     , Wwf         , Wwf         , Wwf         , Gg          , Gll^Ftr     , Gll^Ftr     , Gg          , Ea          , Ce          , Ce          , Ce          , Ea          , Gg          , Gll^Ftr     , Gll^Ftr     , Gll^Ftr     , Gll^Ftr     , Gg          
Wwf         , Wwf         , Wwf         , Wwf         , Wwf         , Wwf         , Ce          , Gll^Ftr     , Gll^Ftr     , Gll^Ftr     , Gll^Ftr     , Gll^Ftr     , Gll^Ftr     , Gll^Ftr     , Gll^Ftr     , Ce          , Gll^Ftr     , Gll^Ftr     , Gll^Ftr     , Wwf         , Wwf         , Wwf         , Gg          , Gll^Ftr     , Gg          , Gll^Ftr     , Gll^Ftr     , Gll^Ftr     , Gll^Ftr     , Gll^Ftr     , Gll^Ftr     , Gll^Ftr     , Gll^Ftr     , Gll^Ftr     , Md          , Md          , Md          
Wwf         , Wwf         , Wwf         , Wwf         , Wwf         , Wwf         , Ce          , Gll^Ftr     , Ea          , Gll^Ftr     , Gll^Ftr     , Gll^Ftr     , Ea          , Gll^Ftr     , Gll^Ftr     , Ce          , Gll^Ftr     , Gll^Ftr     , Wwf         , Wwf         , Wwf         , Wwf         , Gll^Ftr     , Gll^Ftr     , Gll^Ftr     , Gll^Ftr     , Gll^Ftr     , Gll^Ftr     , Gll^Ftr     , Gll^Ftr     , Md          , Md          , Ce          , Ce          , Ce          , Md          , Ce          
Wwf         , Wwf         , Wwf         , Wwf         , Wwf         , Wwf         , Ce          , Gll^Ftr     , Ce          , Ce          , Gll^Ftr     , Ce          , Ce          , Gll^Ftr     , Gll^Ftr     , Ce          , Gll^Ftr     , Gll^Ftr     , Wwf         , Wwf         , Wwf         , Wwf         , Md          , Gll^Ftr     , Md          , Md          , Md          , Gll^Ftr     , Md          , Md          , Ce          , Ce          , Md          , Md          , Md          , Ce          , Ce          
Wwf         , Wwf         , Wwf         , Wwf         , Gll^Ftr     , Gll^Ftr     , Ce          , Gll^Ftr     , Ce          , Gll^Ftr     , Rr          , Gll^Ftr     , Ce          , Gll^Ftr     , Gll^Ftr     , Ce          , Gll^Ftr     , Gll^Ftr     , Wwf         , Wwf         , Wwf         , Wwf         , Ce          , Ce          , Ce          , Ce          , Ce          , Md          , Ce          , Ce          , Gg          , Md          , Md          , Md          , Md          , Md          , Md          
Wwf         , Wwf         , Md          , Md          , Gll^Ftr     , Gll^Ftr     , Ce          , Gll^Ftr     , Ce          , Gll^Ftr     , Gll^Ftr     , Gll^Ftr     , Ce          , Gll^Ftr     , Gll^Ftr     , Ce          , Gll^Ftr     , Wwf         , Wwf         , Wwf         , Wwf         , Wwf         , Md          , Md          , Md          , Ce          , Md          , Ce          , Md          , Gg          , Gg          , Md          , Md          , Md          , Md          , Md          , Md          
Md          , Md          , Md          , Md          , Gll^Ftr     , Gll^Ftr     , Ce          , Gll^Ftr     , Gll^Ftr     , Ce          , Ce          , Ce          , Gll^Ftr     , Gll^Ftr     , Gll^Ftr     , Ce          , Wwf         , Wwf         , Wwf         , Wwf         , Wwf         , Wwf         , Md          , Md          , Md          , Md          , Md          , Md          , Md          , Gg          , Gg          , Gg          , Gg^Fet      , Md          , Md          , Md          , Md          
Md          , Md          , Md          , Md          , Gll^Ftr     , Gll^Ftr     , Gll^Ftr     , Gll^Ftr     , Gll^Ftr     , Gll^Ftr     , Gll^Ftr     , Gll^Ftr     , Gll^Ftr     , Gll^Ftr     , Gll^Ftr     , Gll^Ftr     , Wwf         , Wwf         , Wwf         , Wwf         , Wwf         , Wwf         , Md          , Md          , Md          , Md          , Md          , Md          , Gg          , Gg          , Gg          , Gg          , Gg          , Gg          , Wog         , Gg          , Wog         
Md          , Md          , Md          , Md          , Gll^Ftr     , Gll^Ftr     , Gll^Ftr     , Gll^Ftr     , Gll^Ftr     , Gll^Ftr     , Gll^Ftr     , Gll^Ftr     , Gll^Ftr     , Gll^Ftr     , Gll^Ftr     , Gll^Ftr     , Md          , Wwf         , Wwf         , Wwf         , Wwf         , Wwf         , Wog         , Wog         , Wog         , Md          , Wog         , Md          , Wog         , Gg          , Wog         , Wog         , Wog         , Wog         , Gll^Ftr     , Wog         , Gll^Ftr     
Gll^Fp      , Md          , Md          , Md          , Md          , Gll^Ftr     , Ce          , Ce          , Ce          , Ce          , Ce          , Ce          , Ce          , Ce          , Ce          , Ce          , Md          , Md          , Md          , Wwf         , Wwf         , Wwf         , Gll^Ftr     , Gg          , Gg          , Wog         , Wog         , Wog         , Wog         , Wog         , Wog         , Ss^Vhs      , Gg          , Gll^Ftr     , Gll^Ftr     , Gll^Ftr     , Gll^Ftr     
Gll^Fp      , Md          , Gll^Fp      , Md          , Gll         , Gll         , Gll         , Gll         , Gll         , Gll         , Gll         , Gll^Fp      , Md          , Md          , Md          , Md          , Md          , Md          , Md^Xm       , Wwf         , Wwf         , Wwf         , Md          , Gll^Ftr     , Gll^Ftr     , Gll^Ftr     , Gll^Ftr     , Gg          , Gg          , Wog         , Gll^Ftr     , Wog         , Gg          , Gll^Ftr     , Wog         , Gll^Ftr     , Gll^Ftr     
Gll         , Gll^Fp      , Gll^Fp      , Gll^Fp      , Gll         , Gll         , Gll         , Gll         , Gll         , Gll         , Gll         , Gll^Fp      , Gll^Fp      , Md          , Md          , Md^Xm       , Md^Xm       , Md          , Md^Xm       , Md^Xm       , Md^Xm       , Md^Xm       , Md          , Md          , Md          , Md          , Gll^Ftr     , Gll^Ftr     , Wog         , Wog         , Wog         , Wog         , Wog         , Wog         , Gll^Ftr     , Gll^Ftr     , Gll^Ftr     
Gll         , Gll         , Gll         , Gll         , Md          , Gll         , Md          , Gll         , Md          , Gll         , Gll^Fp      , Gll^Fp      , Wwg         , Md          , Wwg         , Md          , Md          , Md^Xm       , Md^Xm       , Md^Xm       , Md^Xm       , Md^Xm       , Md^Xm       , Md          , Md          , Md          , Wog         , Wog         , Gll^Ftr     , Gll^Ftr     , Gll^Ftr     , Gll^Ftr     , Gll^Ftr     , Gll^Ftr     , Gll^Ftr     , Wog         , Gll^Ftr     
Gll^Fp      , Gll         , Gll         , Gll         , Md          , Md          , Md          , Md          , Md          , Md          , Md          , Wwg         , Wwg         , Wwg         , Gll^Fp      , Gll^Fp      , Md          , Md          , Md          , Md^Xm       , Md^Xm       , Md^Xm       , Md^Xm       , Md^Xm       , Md^Xm       , Md          , Md          , Gll^Ftr     , Gg          , Gll^Ftr     , Gg          , Gg          , Gg          , Gll^Ftr     , Gg          , Gll^Ftr     , Gg          
Gll^Fp      , Gll^Fp      , Gll^Fp      , Gll^Fp      , Wwg         , Md          , Md          , Md          , Ss^Vhs      , Md          , Md          , Md          , Md          , Gll^Fp      , Gll^Fp      , Gll^Fp      , Md          , Md          , Md          , Md^Xm       , Md^Xm       , Md^Xm       , Md^Xm       , Md^Xm       , Md^Xm       , Md          , Md          , Gg          , Gg          , Gg          , Gg          , Gg          , Gg          , Gg          , Gg          , Gg          , Gg          
Gll^Fp      , Gll^Fp      , Wwg         , Wwg         , Wwg         , Wwg         , Gll^Fp      , Gll^Fp      , Gll^Fp      , Gll^Fp      , Gll^Fp      , Gll         , Gll         , Gll         , Gll         , Gll         , Gll         , Md          , Md          , Md^Xm       , Md^Xm       , Md^Xm       , Md^Xm       , Md^Xm       , Md^Xm       , Md^Xm       , Md          , Md          , Md          , Gg          , Gg          , Gg          , Rp          , Gg          , Gg          , Gg          , Gg          
Md          , Gll^Fp      , Md          , Wwg         , Md          , Gll^Fp      , Md          , Gll^Fp      , Gll         , Gll^Fp      , Gll^Fp      , Gll         , Gll^Fp      , Gll^Fp      , Gll^Fp      , Gll         , Gll         , Md          , Md          , Md^Xm       , Md^Xm       , Md^Xm       , Md^Xm       , Md^Xm       , Md^Xm       , Md^Xm       , Md          , Md          , Md          , Gg          , Gg          , Gg          , Gg          , Gg          , Gg          , Gg          , Gg          
Md          , Md          , Md          , Md          , Md          , Md          , Md          , Md          , Md          , Gll^Fp      , Wwg         , Gll^Fp      , Wwg         , Wwg         , Wwg         , Gll^Fp      , Wwg         , Md          , Md          , Md^Xm       , Md          , Md^Xm       , Md^Xm       , Md^Xm       , Md^Xm       , Md^Xm       , Md          , Md          , Ss          , Gg          , Gg          , Gg          , Gg          , Gg          , Gg          , Gg          , Gg          
Md          , Md          , Md          , Md          , Md          , Md          , Md          , Md          , Md          , Md          , Wwg         , Wwg         , Gll^Fp      , Gll^Fp      , Wwg         , Wwg         , Gll^Fp      , Md          , Md          , Md          , Md          , Md          , Md          , Md          , Md          , Md          , Md          , Md          , Ss          , Ss          , Ss          , Ea          , Ss          , Ss          , Ss          , Ss          , Ss          
Gll         , Md          , Gll         , Md          , Gll         , Md          , Gll         , Md          , Gll         , Gll^Fp      , Gll^Fp      , Wwg         , Gll^Fp      , Wwg         , Gll^Fp      , Wwg         , Wwg         , Md          , Md          , Md          , Md          , Md          , Md          , Md          , Md          , Md          , Md          , Md          , Ss          , Ss          , Ss          , Ss          , Ss          , Ss          , Wot         , Ss          , Wot         
Gll         , Gll         , Gll         , Gll         , Gll         , Gll         , Gll         , Gll         , Gll         , Gll         , Gll^Fp      , Gll^Fp      , Gll^Fp      , Gll^Fp      , Gll^Fp      , Gll^Fp      , Md          , Md          , Md          , Md          , Md          , Md          , Md          , Md          , Md          , Md          , Wot         , Wot         , Ss          , Ss          , Ss          , Ss          , Ss          , Ss          , Ss          , Wot         , Wot         
Wwrg        , Wwrg        , Wwrg        , Gll         , Wwrg        , Gll         , Wwrg        , Gll         , Gll         , Gll         , Gll         , Gll^Fp      , Gll         , Gll^Fp      , Md          , Md          , Md          , Md          , Md          , Md          , Md          , Md          , Md          , Md          , Md          , Wot         , Wot         , Wot         , Wot         , Ss          , Ss          , Ss          , Wot         , Wot         , Wot         , Wot         , Wot         
Gg          , Wwrg        , Gg          , Wwrg        , Gg          , Wwrg        , Gg          , Wwrg        , Wwrg        , Gll         , Wwrg        , Gll         , Gll         , Md          , Md          , Md          , Md          , Md          , Md          , Md          , Md          , Md          , Md          , Md          , Wot         , Wot         , Wot         , Wot         , Wot         , Wot         , Wot         , Wot         , Wot         , Wot         , Wot         , Wot         , Wot         
Gg          , Gg          , Gg          , Gg          , Gg          , Gg          , Gg          , Gg          , Gg          , Wwrg        , Wwrg        , Wwrg        , Wwrg        , Md          , Md          , Md          , Md          , Md          , Md          , Md          , Md          , Md          , Wot         , Wot         , Wot         , Wot         , Wot         , Wot         , Wot         , Wot         , Wot         , Wot         , Wot         , Wot         , Wot         , Wot         , Wot         
Gg          , Gg          , Gg          , Gg          , Gg          , Gg          , Gg          , Gg          , Gg          , Gg          , Gg          , Gg          , Md          , Md          , Md          , Md          , Md          , Md          , Md          , Md          , Wot         , Wot         , Wot         , Wot         , Wot         , Wot         , Wot         , Wot         , Wot         , Wot         , Wot         , Wot         , Wot         , Wot         , Wot         , Wot         , Wot         
Gg          , Gg          , Gg          , Gg          , Gg          , Rrc         , Gg          , Gg          , Gg          , Gg          , Gg          , Ea          , Md          , Md          , Md          , Md          , Md          , Md          , Md          , Md          , Wot         , Wot         , Wot         , Wot         , Wot         , Wot         , Wot         , Wot         , Wot         , Wot         , Wot         , Wot         , Wot         , Wot         , Wot         , Wot         , Wot         
Gg          , Gg          , Gg          , Gg          , Gg          , Gg          , Gg          , Gg          , Gg          , Gg          , Gg          , Md          , Md          , Md          , Md          , Md          , Md          , Md          , Md          , Md          , Wot         , Wot         , Wot         , Wot         , Wot         , Wot         , Wot         , Wot         , Wot         , Wot         , Wot         , Wot         , Wot         , Wot         , Wot         , Wot         , Wot         
Gg          , Gg          , Gg          , Gg          , Gg          , Gg          , Gg          , Gg          , Gg          , Gg          , Gg          , Md          , Md          , Md          , Md          , Md          , Md          , Md          , Md          , Md          , Wot         , Wot         , Wot         , Wot         , Wot         , Wot         , Wot         , Wot         , Wot         , Wot         , Wot         , Wot         , Wot         , Wot         , Wot         , Wot         , Wot         
