border_size=1
usage=map

Md          , Md          , Md          , Md          , Md          , Md          , Gll^Ftr     , Gll^Ftr     , Gll^Ftr     , Gll^Ftr     , Gll^Ftr     , Wwg         , Wwg         , Wwg         , Gll^Ftr     , Gll^Ftr     , Gll^Ftr     , Gll^Ftr     , Gll^Ftr     , Gll^Ftr     , Wwg         , Wwg         , Md          , Md          , Md          , Md          , Md          , Md          , Md          , Md          , Md          , Md          , Md          , Md          , Md          
Md          , Md          , Md          , Md          , Gll^Ftr     , Gll^Ftr     , Gg          , Gg          , Gg          , Gll^Ftr     , Gll^Ftr     , Wwg         , Wwg         , Wwg         , Wwg         , Gg          , Wwg         , Gg          , Gg          , Gll^Ftr     , Wwg         , Wwg         , Wwg         , Hh          , Hh          , Md          , Hh          , Md          , Md          , Md          , Md          , Md          , Md          , Md          , Md          
Md          , Md          , Md          , Md          , Gll^Ftr     , Gg          , Gg          , Gg          , Wwg         , Wwg         , Wwg         , Wwg         , Wwg         , Wwg         , Wwg         , Wwg         , Wwg         , Wwg         , Gll^Ftr     , Wwg         , Wwg         , Wwg         , Wwg         , Wwg         , Wwg         , Hh          , Md          , Hh          , Hh          , Hh          , Wwg         , Md          , Md          , Md          , Md          
Wwg         , Wwg         , Wwg         , Wwg         , Wwg         , Wwg         , Gll^Ftr     , Wwg         , Gll^Ftr     , Wwg         , Gll^Ftr     , Gll^Ftr     , Wwg         , Gll^Ftr     , Gll^Ftr     , Wwg         , Wwg         , Wwg         , Gll^Ftr     , Gll^Ftr     , Gll^Ftr     , Wwg         , Md          , Gg          , Md          , Md          , Md          , Md          , Md          , Md          , Wwg         , Wwg         , Wwg         , Md          , Md          
Wwg         , Wwg         , Gll^Ftr     , Wwg         , Gll^Ftr     , Gll^Ftr     , Gg          , Gll^Ftr     , Gg          , Gll^Ftr     , Gg          , Gll^Ftr     , Gll^Ftr     , Gll^Ftr     , Wwg         , Gll^Ftr     , Md          , Md          , Md          , Md          , Md          , Md          , Md          , Md          , Md          , Md          , Md          , Md          , Md          , Md          , Wwg         , Wwg         , Wwg         , Md          , Md          
Wwg         , Wwg         , Gll^Ftr     , Gll^Ftr     , Gg          , Gll^Ftr     , Gg          , Gg          , Gg          , Gg          , Gg          , Ea          , Gll^Ftr     , Gll^Ftr     , Gll^Ftr     , Wwg         , Md          , Md          , Md          , Md          , Md          , Md          , Md          , Md          , Md          , Md          , Gll^Fdf     , Md          , Gll^Fdf     , Gll^Fdf     , Gll^Fdf     , Wwg         , Wwg         , Wwg         , Wwg         
Gll^Ftr     , Gll^Ftr     , Gll^Ftr     , Gll^Ftr     , Gg          , Gg          , Gg          , Gg          , Rp          , Gg          , Gg          , Gg          , Gll^Ftr     , Md          , Md          , Gll^Ftr     , Gg          , Md          , Md          , Md          , Md          , Md          , Md          , Md          , Gll^Fdf     , Gll^Fdf     , Gll^Fdf     , Gll^Fdf     , Wwg         , Wwg         , Wwg         , Gll^Fdf     , Wwg         , Wwg         , Wwg         
Md          , Md          , Md          , Gll^Ftr     , Gll^Ftr     , Gg          , Gg          , Gg          , Gg          , Gg          , Gg          , Gg          , Gll^Ftr     , Md          , Md          , Wwg         , Md          , Md          , Md          , Md          , Md          , Md          , Gll^Fdf     , Ea          , Gll^Fdf     , Gll^Fdf     , Gll^Fdf     , Wwg         , Gll^Fdf     , Gll^Fdf     , Wwg         , Wwg         , Gll^Fdf     , Wwg         , Wwg         
Md          , Md          , Md          , Gll^Ftr     , Gll^Ftr     , Gll^Ftr     , Gll^Ftr     , Gll^Ftr     , Gg          , Gg          , Gg          , Ea          , Gll^Ftr     , Md          , Wwg         , Wwg         , Md          , Md          , Md          , Md          , Md          , Gll^Fdf     , Gll^Fdf     , Gll^Fdf     , Gg          , Gll^Fdf     , Gg          , Gll^Fdf     , Gll^Fdf     , Gll^Fdf     , Wwg         , Wwg         , Wwg         , Gll^Fdf     , Gll^Fdf     
Wwg         , Md          , Wwg         , Md          , Md          , Md          , Md          , Gll^Ftr     , Gll^Ftr     , Gll^Ftr     , Gll^Ftr     , Gll^Ftr     , Gll^Ftr     , Md          , Wwg         , Wwg         , Md          , Md          , Md          , Md          , Gll^Fdf     , Gll^Fdf     , Gg          , Gg          , Gg          , Gg          , Gg          , Gg          , Gg          , Gll^Fdf     , Gll^Fdf     , Wwg         , Wwg         , Gll^Fdf     , Gll^Fdf     
Gg          , Wwg         , Wwg         , Md          , Wwg         , Md          , Wwg         , Gll^Ftr     , Gll^Ftr     , Gll^Ftr     , Gll^Ftr     , Gll^Ftr     , Gll^Ftr     , Gll^Ftr     , Wwg         , Wwg         , Wwg         , Md          , Md          , Gll^Fdf     , Gll^Fdf     , Gll^Fdf     , Gg          , Gg          , Gg          , Gg          , Rr          , Gg          , Gg          , Gg          , Md          , Md          , Wwg         , Wwg         , Gll^Fmf     
Gg          , Gll^Ftr     , Gll^Ftr     , Wwg         , Wwg         , Wwg         , Wwg         , Wwg         , Wwg         , Wwg         , Wwg         , Wwg         , Wwg         , Wwg         , Wwg         , Wwg         , Wwg         , Md          , Wwg         , Gll^Fdf     , Gll^Fdf     , Gll^Fdf     , Gg          , Gg          , Gg          , Gg          , Gg          , Gg          , Gg          , Gg          , Md          , Md          , Gll^Fmf     , Wwg         , Wwg         
Gg          , Gll^Ftr     , Gll^Ftr     , Gll^Ftr     , Gll^Ftr     , Gll^Ftr     , Wwg         , Wwg         , Gg          , Wwg         , Wwg         , Wwg         , Md          , Wwg         , Md          , Wwg         , Wwg         , Wwg         , Wwg         , Wwg         , Gll^Fmf     , Gll^Fdf     , Gll^Fmf     , Gg          , Gg          , Gg          , Gg          , Gg          , Gg          , Gg          , Md          , Md          , Gll^Fmf     , Wwg         , Gll^Fmf     
Gg          , Gg          , Gll^Ftr     , Gll^Ftr     , Gll^Ftr     , Wwg         , Wwg         , Wwg         , Gll^Ftr     , Gll^Ftr     , Gll^Ftr     , Gll^Ftr     , Gll^Ftr     , Md          , Md          , Md          , Wwg         , Wwg         , Wwg         , Wwg         , Wwg         , Gll^Fmf     , Gll^Fmf     , Gll^Fmf     , Gll^Fmf     , Gg          , Gg          , Gg          , Gll^Fdf     , Ea          , Gll^Fmf     , Gll^Fmf     , Ss          , Wwg         , Gll^Fmf     
Gg          , Gll^Ftr     , Gll^Ftr     , Gll^Ftr     , Gll^Ftr     , Wwg         , Wwg         , Wwg         , Gg          , Gll^Ftr     , Wwg         , Gll^Ftr     , Wwg         , Gll^Ftr     , Wwg         , Wwg         , Wwg         , Wwg         , Wwg         , Wwg         , Wwg         , Wwg         , Wwg         , Wwg         , Wwg         , Gll^Fdf     , Gll^Fdf     , Gll^Fdf     , Gll^Fdf     , Gll^Fmf     , Ss          , Ss          , Ss          , Gll^Fmf     , Gg          
Wwg         , Wwg         , Wwg         , Gg          , Wwg         , Wwg         , Wwg         , Wwg         , Wwg         , Wwg         , Wwg         , Wwg         , Md          , Wwg         , Ur          , Wwg         , Wwg         , Wwg         , Wwg         , Wwg         , Gs^Ftp      , Wwg         , Wwg         , Wwg         , Wwg         , Wwg         , Wwg^Bw|     , Wwg         , Wwg         , Ss          , Wwg         , Ss          , Ss          , Ss          , Gg          
Hh          , Wwg         , Hh          , Wwg         , Hh          , Hh          , Hh          , Wwg         , Md          , Md          , Md          , Md          , Md          , Ur          , Ur          , Ur          , Wwg         , Wwg         , Wwg         , Wwg         , Wwg         , Gs^Ftp      , Gs^Ftp      , Gs^Ftp      , Wwg         , Wwg         , Gs^Ftp      , Wwg         , Wwg         , Wwg         , Wwg         , Ss          , Wwg         , Ss          , Gg          
Hh          , Hh          , Hh          , Hh          , Hh          , Hh          , Md          , Md          , Md          , Md          , Md          , Md          , Ur          , Ur          , Ur          , Ur          , Ur          , Wwg         , Wwg         , Wwg         , Wwg         , Wwg^Bw|     , Wwg         , Wwg^Bw\r    , Gs^Ftp      , Gs^Ftp      , Gs^Ftp      , Wwg         , Wwg         , Wwg         , Wwg         , Wwg         , Wwg         , Wwg         , Wwg         
Hh          , Hh          , Hh          , Hh          , Gs^Vht      , Md          , Md          , Md          , Md          , Md          , Md          , Md          , Md          , Ur          , Ur          , Ur          , Ur          , Wwg         , Wwg         , Gs^Ftp      , Gs^Ftp      , Gs^Ftp      , Gs^Ftp      , Wwg         , Wwg         , Gs^Ftp      , Wwg         , Wwg         , Wwg         , Wwg         , Wwg         , Wwg         , Wwg         , Wwg         , Wwg         
Hh          , Hh          , Hh          , Hh          , Md          , Md          , Md          , Md          , Md          , Md          , Md          , Md          , Md          , Md          , Md          , Ur          , Ur          , Ur          , Uu^Uf       , Wwg^Bw|     , Wwg         , Wwg         , Wwg         , Wwg         , Uu^Uf       , Wwg         , Wwg         , Wwg         , Wwg         , Wwg         , Wwg         , Wwg         , Wwg         , Wwg         , Wwg         
Hh          , Hh          , Hh          , Hh          , Md          , Md          , Md          , Md          , Gll^Ftr     , Gll^Ftr     , Gll^Ftr     , Md          , Md          , Md          , Md          , Md          , Md          , Ur          , Uu^Uf       , Uu^Uf       , Uu^Uf       , Uu^Uf       , Uu^Uf       , Uu^Uf       , Uu^Uf       , Uu^Uf       , Uu^Uf       , Wwg         , Wwg         , Wwg         , Md          , Wwg         , Wwg         , Wwg         , Wwg         
Hh          , Hh          , Hh          , Hh          , Hh          , Md          , Gll^Ftr     , Gll^Ftr     , Gll^Ftr     , Gll^Ftr     , Ce          , Wwf         , Wwf         , Md          , Md          , Md          , Md          , Md          , Md          , Uu^Uf       , Uu^Uf       , Uu^Uf       , Uu^Uf       , Uu^Uf       , Uu^Uf       , Uu^Uf       , Uu^Uf       , Wwg         , Wwg         , Md          , Md          , Md          , Md          , Wwg         , Md          
Hh          , Hh          , Hh          , Hh          , Gll^Ftr     , Gll^Ftr     , Gs^Ft       , Gll^Ftr     , Gll^Ftr     , Ce          , Ce          , Ce          , Gg          , Wwf         , Wwf         , Md          , Md          , Md          , Md          , Gll^Ftr     , Gll^Ftr     , Uu^Uf       , Uu^Uf       , Uu^Uf       , Uu^Uf       , Uu^Uf       , Wwg         , Wwg         , Wwg         , Wwg         , Md          , Md          , Md          , Md          , Md          
Md          , Hh          , Hh          , Hh          , Gll^Ftr     , Gs^Ft       , Gll^Ftr     , Gll^Ftr     , Ce          , Ce          , Gll^Ftr     , Gll^Ftr     , Gg          , Gg          , Wwf         , Ce          , Ce          , Md          , Gll^Ftr     , Md          , Gll^Ftr     , Gll^Ftr     , Gll^Ftr     , Gll^Ftr     , Wwg         , Wwg         , Wwg         , Wwg         , Gll^Ftr     , Gll^Ftr     , Gll^Ftr     , Md          , Md          , Md          , Md          
Md          , Md          , Md          , Gll^Ftr     , Ce          , Ce          , Ce          , Ce          , Gll^Ftr     , Gll^Ftr     , Gg          , Gg          , Gll^Ftr     , Gg          , Gll^Ftr     , Ce          , Ce          , Gll^Ftr     , Gll^Ftr     , Gll^Ftr     , Gll^Ftr     , Gll^Ftr     , Md          , Wwg         , Md          , Wwg         , Md          , Wwg         , Gll^Ftr     , Gll^Ftr     , Gll^Ftr     , Gll^Ftr     , Md          , Md          , Md          
Md          , Md          , Md          , Gs^Ft       , Wwf         , Ce          , Gg          , Gll^Ftr     , Gg          , Gg          , Rp          , Gg          , Gll^Ftr     , Gll^Ftr     , Gll^Ftr     , Gll^Ftr     , Ce          , Gll^Ftr     , Md          , Gll^Ftr     , Md          , Md          , Mm^Xm       , Mm^Xm       , Mm^Xm       , Md          , Md          , Md          , Md          , Md          , Md          , Gll^Ftr     , Gll^Ftr     , Md          , Md          
Md          , Md          , Md          , Md          , Wwf         , Ea          , Gg          , Gg          , Gg          , Gg          , Gg          , Gg          , Gg          , Gg          , Gll^Ftr     , Ce          , Md          , Md          , Md          , Md          , Mm^Xm       , Mm^Xm       , Md          , Md          , Md          , Md          , Md          , Md          , Md          , Md          , Gll^Ftr     , Gll^Ftr     , Gll^Ftr     , Md          , Md          
Md          , Md          , Md          , Md          , Md          , Wwf         , Wwf         , Gg          , Gll^Ftr     , Gg          , Gll^Ftr     , Gg          , Gg          , Gll^Ftr     , Gll^Ftr     , Ce          , Md          , Md          , Mm^Xm       , Mm^Xm       , Md          , Md          , Gll^Ftr     , Gll^Ftr     , Wwg         , Wwg         , Wwg         , Wwg         , Wwg         , Gll^Ftr     , Wwg         , Gll^Ftr     , Wwg         , Gll^Ftr     , Wwg         
Md          , Md          , Md          , Md          , Md          , Md          , Md          , Wwf         , Ea          , Gll^Ftr     , Gg          , Gg          , Gll^Ftr     , Gll^Ftr     , Md          , Md          , Md          , Md          , Mm^Xm       , Md          , Md          , Ce          , Gll^Ftr     , Gll^Ftr     , Wwg         , Wwg         , Ce          , Wwg         , Ce          , Wwg         , Ce          , Wwg         , Ce          , Wwg         , Ce          
Md          , Md          , Md          , Md          , Gll^Ftr     , Md          , Wwf         , Wwf         , Wwf         , Gll^Ftr     , Wwf         , Wwf         , Gll^Ftr     , Gll^Ftr     , Gll^Ftr     , Md          , Md          , Md          , Mm^Xm       , Md          , Md          , Ce          , Md          , Md          , Wwg         , Ce          , Gll^Ftr     , Ce          , Gll^Ftr     , Ce          , Gll^Ftr     , Ce          , Ea          , Ce          , Gll^Ftr     
Md          , Md          , Md          , Gll^Ftr     , Gll^Ftr     , Gll^Ftr     , Wwf         , Wwf         , Wwf         , Wwf         , Wwf         , Gll^Ftr     , Gll^Ftr     , Gll^Ftr     , Gll^Ftr     , Gll^Ftr     , Gll^Ftr     , Md          , Mm^Xm       , Md          , Gll^Ftr     , Ce          , Md          , Md          , Wwg         , Ce          , Gll^Ftr     , Gg          , Gg          , Gg          , Gg          , Gg          , Gg          , Gll^Ftr     , Gll^Ftr     
Md          , Md          , Md          , Md          , Gll^Ftr     , Gll^Ftr     , Gll^Ftr     , Wwf         , Gll^Ftr     , Wwf         , Wwf         , Wwf         , Md          , Gll^Ftr     , Gll^Ftr     , Gll^Ftr     , Gll^Ftr     , Gll^Ftr     , Gll^Ftr     , Md          , Ce          , Ce          , Md          , Md          , Wwg         , Ce          , Gll^Ftr     , Gg          , Gg          , Rr          , Gg          , Gg          , Gg          , Gll^Ftr     , Gll^Ftr     
Md          , Md          , Gll^Ftr     , Gll^Ftr     , Gll^Ftr     , Gll^Ftr     , Gll^Ftr     , Gll^Ftr     , Gll^Ftr     , Gll^Ftr     , Md          , Md          , Md          , Md          , Md          , Gll^Ftr     , Gll^Ftr     , Gll^Ftr     , Gll^Ftr     , Ce          , Gll^Ftr     , Md          , Md          , Gll^Ftr     , Wwg         , Ce          , Gll^Ftr     , Gg          , Gg          , Gg          , Gg          , Gg          , Gg          , Gll^Ftr     , Gll^Ftr     
Gg          , Wwf         , Wwf         , Wwf         , Wwf         , Wwf         , Md          , Gll^Ftr     , Md          , Md          , Md          , Md          , Md          , Md          , Md          , Md          , Md          , Gll^Ftr     , Ce          , Ce          , Gll^Ftr     , Md          , Gll^Ftr     , Gll^Ftr     , Wwg         , Ce          , Gll^Ftr     , Gg          , Gll^Ftr     , Gg          , Gll^Ftr     , Gg          , Ea          , Gll^Ftr     , Gll^Ftr     
Gg          , Gg          , Gg          , Wwf         , Gg          , Md          , Md          , Md          , Md          , Md          , Md          , Md          , Md          , Md          , Md          , Md          , Md          , Md          , Gll^Ftr     , Gll^Ftr     , Gll^Ftr     , Gll^Ftr     , Gll^Ftr     , Wwg         , Gg          , Ce          , Gll^Ftr     , Gll^Ftr     , Gll^Ftr     , Gll^Ftr     , Gll^Ftr     , Gll^Ftr     , Gll^Ftr     , Gll^Ftr     , Gll^Ftr     
