border_size=1
usage=map

_off^_usr   , _off^_usr   , _off^_usr   , _off^_usr   , _off^_usr   , _off^_usr   , _off^_usr   , _off^_usr   , _off^_usr   , _off^_usr   , _off^_usr   , _off^_usr   , _off^_usr   , _off^_usr   , _off^_usr   , _off^_usr   , _off^_usr   , _off^_usr   , _off^_usr   , _off^_usr   , _off^_usr   , _off^_usr   , _off^_usr   , _off^_usr   , _off^_usr   , _off^_usr   , _off^_usr   , _off^_usr   , _off^_usr   , _off^_usr   , _off^_usr   , _off^_usr   , _off^_usr   , _off^_usr   , _off^_usr   , _off^_usr   , _off^_usr   , _off^_usr   , _off^_usr   , _off^_usr   , _off^_usr   , _off^_usr   , _off^_usr   
_off^_usr   , _off^_usr   , _off^_usr   , _off^_usr   , _off^_usr   , _off^_usr   , _off^_usr   , _off^_usr   , _off^_usr   , _off^_usr   , _off^_usr   , _off^_usr   , _off^_usr   , _off^_usr   , _off^_usr   , _off^_usr   , _off^_usr   , _off^_usr   , _off^_usr   , _off^_usr   , _off^_usr   , _off^_usr   , _off^_usr   , _off^_usr   , _off^_usr   , _off^_usr   , _off^_usr   , _off^_usr   , _off^_usr   , _off^_usr   , _off^_usr   , _off^_usr   , _off^_usr   , _off^_usr   , _off^_usr   , _off^_usr   , _off^_usr   , _off^_usr   , _off^_usr   , _off^_usr   , _off^_usr   , _off^_usr   , _off^_usr   
_off^_usr   , _off^_usr   , _off^_usr   , _off^_usr   , _off^_usr   , _off^_usr   , _off^_usr   , _off^_usr   , _off^_usr   , _off^_usr   , _off^_usr   , _off^_usr   , Mm^Xm       , Mm^Xm       , Mm^Xm       , Gs^Fp       , Mm^Xm       , Gs^Fp       , Hh          , Gs^Fms      , Ww          , Ww          , Ww          , Gs^Fp       , Gs^Fms      , Hh          , Mm^Xm       , Gs^Fp       , Mm^Xm       , Mm^Xm       , Mm          , _off^_usr   , _off^_usr   , _off^_usr   , _off^_usr   , _off^_usr   , _off^_usr   , _off^_usr   , _off^_usr   , _off^_usr   , _off^_usr   , _off^_usr   , _off^_usr   
_off^_usr   , _off^_usr   , _off^_usr   , _off^_usr   , _off^_usr   , _off^_usr   , _off^_usr   , _off^_usr   , _off^_usr   , _off^_usr   , Gs^Fp       , Mm          , Gg^Fet      , Mm          , Gs^Fp       , Mm^Xm       , Gs^Fms      , Gg^Ve       , Gg          , Hh          , Mm          , Ww          , Gs^Fp       , Hh          , Gg          , Mm          , Gg^Fet      , Mm^Xm       , Mm          , Mm          , Hh          , Gs^Fp       , Ggf         , _off^_usr   , _off^_usr   , _off^_usr   , _off^_usr   , _off^_usr   , _off^_usr   , _off^_usr   , _off^_usr   , _off^_usr   , _off^_usr   
_off^_usr   , _off^_usr   , _off^_usr   , _off^_usr   , _off^_usr   , _off^_usr   , _off^_usr   , _off^_usr   , Hh          , Ggf         , Gg          , Hh          , Gg^Ve       , Hh          , Gs^Fms      , Mm          , Ea          , Ggf         , Gg          , Gg          , Gg          , 1 Wwf       , Gg          , Gg          , Hh          , Gg          , Gg          , Gs^Fp       , Gg          , Gg          , Gg          , Gg          , Gs^Fms      , Wwf         , Wwf         , _off^_usr   , _off^_usr   , _off^_usr   , _off^_usr   , _off^_usr   , _off^_usr   , _off^_usr   , _off^_usr   
_off^_usr   , _off^_usr   , _off^_usr   , _off^_usr   , _off^_usr   , _off^_usr   , Xu          , Wwf         , Gg          , Gg          , Gg          , Gg          , Gg          , Gg          , Gg          , Gg          , Ea          , Gg          , Kh          , Ch          , Gg          , Wwf         , Gg          , Ch          , Kh          , Gs^Fp       , Mm          , Gg          , Gg          , Gg          , Gg          , Gg          , Gg          , Mm          , Wwf         , Xu          , Xu          , _off^_usr   , _off^_usr   , _off^_usr   , _off^_usr   , _off^_usr   , _off^_usr   
_off^_usr   , _off^_usr   , _off^_usr   , _off^_usr   , Xu          , Xu          , Wwf         , Wwf         , Gg          , Gg          , Gg          , Gg          , Gg          , Gg          , Re          , Gg          , Re          , Gg          , Gg          , Gg          , Gg          , Wwf         , Gg          , Gg          , Gg          , Gg          , Gg          , Gg          , Gg          , Hh          , Gs^Fp       , Gg^Ve       , Gg          , Ggf         , Mm          , Wwf         , Xu          , Xu          , Xu          , _off^_usr   , _off^_usr   , _off^_usr   , _off^_usr   
_off^_usr   , _off^_usr   , Xu          , Xu          , Xu          , Xu          , Wwf         , Gg          , Gg          , Gs^Fp       , Hh          , Gs^Fp       , Gg          , Gg          , Re          , Re          , Xu          , Re          , Re^Uf       , Gg          , Re          , Wwf         , Gg          , Gs^Fms      , Gg          , Re          , Re          , Re          , Xu          , Gg          , Gg          , Hh          , Gg          , Gg          , Gs^Fp       , Wwf         , Wwf         , Xu          , Uh          , Xu          , Xu          , _off^_usr   , _off^_usr   
_off^_usr   , _off^_usr   , Xu          , Xu          , Wwf         , Wwf         , Mm          , Gg          , Gg          , Re^Uf       , Mm          , Gg          , Re          , Re          , Ww          , Xu          , Uh          , Uu^Vud      , Xu          , Re          , Wwf         , Wwf         , Re          , Gg          , Re          , Re          , Wwf         , Xu          , Xu          , Re^Uf       , Re          , Gg          , Gg          , Hh          , Ggf         , Hh          , Wwf         , Xu          , Wwf         , Uu          , Uu^Uf       , _off^_usr   , _off^_usr   
_off^_usr   , _off^_usr   , Xu          , Wwf         , Gs^Fp       , Hh          , Hh          , Gg          , Gg          , Hh          , Gs^Fms      , Gg          , Re          , Ww          , Wo          , Ww          , Wwf         , Wwf         , Uh          , Uu^Uf       , Wwf         , Ww          , Ss^Vhs      , Re          , Xu          , Wwf         , Ur          , Ur          , Re          , Re          , Gs^Fms      , Hh          , Gg^Uf       , Gg          , Gg          , Re          , Re^Uf       , Wwf         , Wwf         , Uu          , Xu          , _off^_usr   , _off^_usr   
_off^_usr   , _off^_usr   , Wwf         , Wwf         , Ggf         , Ggf         , Gg          , Gg          , Gg          , Gg          , Gg          , Gg          , Re          , Ww          , Ww          , Ww          , Xu          , Uh          , Xu          , Ur          , Ww          , Ww          , Ww          , Xu          , Ww          , Uh          , Uu^Vu       , Re          , Gg          , Gg          , Gg          , Gg^Ve       , Gg          , Gg          , Gg          , Gg          , Re          , Gs^Fp       , Wwf         , Xu          , Xu          , _off^_usr   , _off^_usr   
_off^_usr   , _off^_usr   , Gs^Fms      , Gs^Fp       , Re^Uf       , Re          , Gg          , Gg          , Gg          , Gg          , Gg          , Ss^Vhs      , Gg          , Re          , Wwf         , Uh          , Xu          , Ur          , Xu          , Wwf         , Ww          , Wo          , Uu          , Uh          , Ww          , Xu          , Xu          , Re          , Re          , Gg          , Gg          , Gg          , Gs^Fms      , Hh          , Hh          , Gg          , Gg          , Re          , Re          , Wwf         , Xu          , _off^_usr   , _off^_usr   
_off^_usr   , _off^_usr   , Mm          , Hh          , Re          , Re          , Gg          , Gg          , Hh          , Gs^Fp       , Ss          , Gg          , Hh          , Re          , Wwf         , Xu          , Xu          , Ur          , Wwf         , Wwf         , Ww          , Uu^Uf       , Ww          , Ww          , Wwf         , Uu^Uf       , Xu          , Uh          , Wwf         , Re          , Hh          , Hh          , Mm          , Gs^Fp       , Hh          , Gs^Fp       , Gg          , Re          , Re          , Wwf         , Wwf         , _off^_usr   , _off^_usr   
_off^_usr   , _off^_usr   , Wwf         , Re^Uf       , Re          , Gg          , Gg          , Gs^Fp       , Re^Uf       , Gs^Fms      , Mm          , Gs^Fp       , Hh          , Re          , Re          , Uh          , Xu          , Uu^Uf       , Ww          , Ww          , Uu          , Uu^Uf       , Ww          , Wwf         , Xu          , Ur          , Xu          , Xu          , Wwf         , Re          , Re          , Gs^Fp       , Gg          , Ss          , Gg          , Gg          , Gg          , Gg          , Gg          , Re^Uf       , Mm          , _off^_usr   , _off^_usr   
_off^_usr   , _off^_usr   , Xu          , Wwf         , Re          , Gg          , Gg          , Gg          , Gg          , Hh          , Gg          , Hh          , Gg          , Gg          , Gg          , Re          , Uu^Vu       , Xu          , Ww          , Uh          , Ww          , Wo          , Ww          , Wwf         , Xu          , Ur          , Xu          , Uh          , Ww          , Re          , Re          , Gg          , Gg          , Gg          , Gg          , Gg          , Gg          , Ggf         , Hh          , Hh          , Gs^Fp       , _off^_usr   , _off^_usr   
_off^_usr   , _off^_usr   , Xu          , Wwf         , Wwf         , Hh          , Hh          , Gg          , Gg          , Gg          , Gg          , Gg          , Gg          , Gg          , Re          , Re          , Ur          , Uh          , Xu          , Xu          , Ss^Vhs      , Ww          , Wwf         , Ur          , Uh          , Uh          , Wwf         , Ww          , Wo          , Ww          , Re          , Re          , Gg          , Gg          , Gs^Fms      , Gg          , Gg          , Gg          , Gg          , Gs^Fp       , Wwf         , _off^_usr   , _off^_usr   
_off^_usr   , _off^_usr   , Xu          , Xu          , Wwf         , Gs^Fp       , Re          , Gg          , Ggf         , Gg          , Gg          , Gg          , Gg          , Gs^Fp       , Xu          , Ur          , Wwf         , Wwf         , Re          , Re          , Re          , Ww          , Wwf         , Uu^Uf       , Xu          , Wwf         , Uh          , Ww          , Ww          , Ww          , Re          , Ss^Vhs      , Gg          , Hh          , Mm          , Hh          , Re^Uf       , Gg          , Gg          , Wwf         , Xu          , _off^_usr   , _off^_usr   
_off^_usr   , _off^_usr   , Uu^Uf       , Uu          , Wwf         , Wwf         , Wwf         , Re          , Hh          , Mm          , Gs^Fp       , Gg          , Gg          , Uh          , Xu          , Xu          , Re          , Re          , Gg          , Gg          , Gg          , Wwf         , Re          , Re          , Re^Uf       , Uu^Vud      , Xu          , Xu          , Re          , Re          , Gg          , Gg          , Gg          , Gs^Fms      , Ggf         , Gs^Fp       , Gg          , Gg          , Wwf         , Wwf         , Xu          , _off^_usr   , _off^_usr   
_off^_usr   , _off^_usr   , Xu          , Wwf         , Uh          , Xu          , Xu          , Wwf         , Re          , Re^Uf       , Ggf         , Gg^Uf       , Gs^Fp       , Gg          , Gg          , Re          , Gg          , Re          , Gg          , Gs^Fp       , Gg          , Wwf         , Gg          , Gg          , Gg          , Re          , Re          , Re          , Re          , Gg          , Gg          , Gg          , Gg          , Gg          , Gg          , Gg          , Wwf         , Wwf         , Xu          , Xu          , Xu          , _off^_usr   , _off^_usr   
_off^_usr   , _off^_usr   , _off^_usr   , Xu          , Xu          , Xu          , Xu          , Wwf         , Re          , Gs^Fms      , Gg          , Gg^Ve       , Ggf         , Gg          , Gg          , Gg          , Ggf         , Gg          , Kh          , Gg          , Gg          , Wwf         , Gg          , Gg          , Kh          , Gg          , Ea          , Gg          , Gg          , Gg          , Gg          , Gg          , Gg          , Gg          , Gg          , Gg          , Wwf         , Xu          , Xu          , Xu          , _off^_usr   , _off^_usr   , _off^_usr   
_off^_usr   , _off^_usr   , _off^_usr   , _off^_usr   , _off^_usr   , Xu          , Xu          , Wwf         , Wwf         , Re          , Mm          , Hh          , Gg          , Gg          , Gg          , Gg^Ve       , Gg          , Gs^Fms      , Gg          , Ch          , Gg          , Wwf         , Gg          , Ch          , Gg          , Gg          , Ea          , Gg          , Gg^Fet      , Gg          , Gg^Ve       , Gg          , Gg          , Gs^Fp       , Gg          , Wwf         , Xu          , Xu          , _off^_usr   , _off^_usr   , _off^_usr   , _off^_usr   , _off^_usr   
_off^_usr   , _off^_usr   , _off^_usr   , _off^_usr   , _off^_usr   , _off^_usr   , _off^_usr   , Xu          , Wwf         , Re          , Re          , Gs^Fp       , Re          , Gg          , Hh          , Hh          , Gs^Fms      , Gg          , Gg          , Hh          , Mm          , 2 Wwf       , Gs^Fp       , Gg          , Gg          , Gg^Ve       , Gs^Fp       , Gg          , Hh          , Hh          , Gs^Fp       , Hh          , Gs^Fms      , Gg          , Wwf         , Wwf         , _off^_usr   , _off^_usr   , _off^_usr   , _off^_usr   , _off^_usr   , _off^_usr   , _off^_usr   
_off^_usr   , _off^_usr   , _off^_usr   , _off^_usr   , _off^_usr   , _off^_usr   , _off^_usr   , _off^_usr   , _off^_usr   , Wwf         , Re          , Re          , Re          , Gs^Fp       , Mm          , Mm          , Mm          , Mm          , Gs^Fms      , Gg^Fet      , Hh          , Ww          , Hh          , Hh          , Gs^Fms      , Hh          , Mm          , Hh          , Mm^Xm       , Mm          , Mm          , Hh          , Gs^Fp       , Mm          , _off^_usr   , _off^_usr   , _off^_usr   , _off^_usr   , _off^_usr   , _off^_usr   , _off^_usr   , _off^_usr   , _off^_usr   
_off^_usr   , _off^_usr   , _off^_usr   , _off^_usr   , _off^_usr   , _off^_usr   , _off^_usr   , _off^_usr   , _off^_usr   , _off^_usr   , _off^_usr   , Mm          , Hh          , Hh          , Mm^Xm       , Mm^Xm       , Mm^Xm       , Mm^Xm       , Mm^Xm       , Mm          , Mm^Xm       , Ww          , Ww          , Mm          , Mm^Xm       , Mm^Xm       , Mm^Xm       , Mm^Xm       , Mm          , Mm^Xm       , Mm          , Hh          , _off^_usr   , _off^_usr   , _off^_usr   , _off^_usr   , _off^_usr   , _off^_usr   , _off^_usr   , _off^_usr   , _off^_usr   , _off^_usr   , _off^_usr   
_off^_usr   , _off^_usr   , _off^_usr   , _off^_usr   , _off^_usr   , _off^_usr   , _off^_usr   , _off^_usr   , _off^_usr   , _off^_usr   , _off^_usr   , _off^_usr   , _off^_usr   , Mm^Xm       , _off^_usr   , Mm          , _off^_usr   , Gs^Fp       , _off^_usr   , Mm^Xm       , _off^_usr   , Ww          , _off^_usr   , Gs^Fp       , _off^_usr   , Hh          , _off^_usr   , Gs^Fp       , _off^_usr   , Mm^Xm       , _off^_usr   , _off^_usr   , _off^_usr   , _off^_usr   , _off^_usr   , _off^_usr   , _off^_usr   , _off^_usr   , _off^_usr   , _off^_usr   , _off^_usr   , _off^_usr   , _off^_usr   
_off^_usr   , _off^_usr   , _off^_usr   , _off^_usr   , _off^_usr   , _off^_usr   , _off^_usr   , _off^_usr   , _off^_usr   , _off^_usr   , _off^_usr   , _off^_usr   , _off^_usr   , _off^_usr   , _off^_usr   , _off^_usr   , _off^_usr   , _off^_usr   , _off^_usr   , _off^_usr   , _off^_usr   , _off^_usr   , _off^_usr   , _off^_usr   , _off^_usr   , _off^_usr   , _off^_usr   , _off^_usr   , _off^_usr   , _off^_usr   , _off^_usr   , _off^_usr   , _off^_usr   , _off^_usr   , _off^_usr   , _off^_usr   , _off^_usr   , _off^_usr   , _off^_usr   , _off^_usr   , _off^_usr   , _off^_usr   , _off^_usr   
