border_size=1
usage=map

Cud         , Cud         , Cud         , Wo          , Ur          , Xu          , Xu          , Xu          , Uh          , Wwf         , Ur          , Ur          , Ur          , Xu          , Cud         , Uu          , Ur          , Uu          , Xu          , Xu          , Rb          , Rb          , Hh^Fp       , Gs^Fp       , Mm          , Gs^Fp       , Gg^Efm      , Hh          , Rb          , Rb          , Gs^Fp       , Gg          , Wwf         , Gg^Fms      , Hh          , Gg          , Gs^Fms      , Gs^Fp       , Gg          , Gg          , Gg          , Hh          , Mm          
Wo          , Wo          , Ur          , Cud         , Uu^Vu       , Ur          , Xu          , Cud         , Cud         , Wwf         , Ur          , Ur          , Ur          , Xu          , Uu^Uf       , Uu          , Ur          , Uu^Vu       , Xu          , Xu          , Rb          , Gg^Fp       , Hh          , Mm          , Hh          , Gg^Efm      , Gg          , Gs^Vht      , Gg          , Rb          , Rb^Fp       , Gg          , Wwf         , Gg^Fp       , Gg          , Gg          , Gg          , Gg          , Ch          , Ch          , 1 Kh        , Hh          , Hh          
Uu^Uf       , Uu^Uf       , Uu^Uf       , Wwf         , Wwf         , Wwf         , Wwf         , Uh          , Ur          , Ur          , Cud         , Xu          , Uu^Vu       , Ur          , Ur          , Ur          , Xu          , Rb          , Rb          , Rb          , Gg          , Gg^Vc       , Gg          , Gs^Fet      , Gg^Efm      , Hh          , Gg          , Gg          , Wwf         , Gg          , Wwf         , Wwf         , Ww          , Wwf         , Wwf         , Wwf         , Wwf         , Ch          , Wwf         , Ch          , Ch          , Wwf         , Wwf         
Xu          , Xu          , Wwf         , Wwf         , Ur          , Ur          , Xu          , Ur          , Xu          , Xu          , Rb          , Xu          , Xu          , Cud         , Rb          , Xu          , Gg          , Gg          , Gg          , Gg          , Rr          , Gg          , Rr          , Gg          , Gg          , Gg          , Gg          , Wwf         , Ww          , Wwf         , Ww          , Ww          , Wo          , Ww          , Ww          , Ww^Vm       , Wwf         , Wwf         , Ch          , Ch          , Rr          , Gg          , Gg          
Uu^Uf       , Uu^Uf       , Wwf         , Xu          , Cud         , Xu          , Xu          , Cud         , Xu          , Gg          , Rb^Fp       , Gg          , Gg          , Xu          , Rr          , Gg          , Rr          , Rr          , Rr          , Rr          , Gg          , Rr          , Gg          , Rr          , Rr          , Gg          , Wwf         , Wwf         , Ww          , Ww          , Wo          , Wo          , Wo          , Wo          , Ww          , Wwf         , Gg          , Gg          , Gg          , Rr          , Gg          , Gg          , Gg          
Wwf         , Wwf         , Ur          , Xu          , Wwf         , Ur          , Rr          , Rr          , Rr          , Rr          , Rr          , Hh          , Rr          , Rr          , Wwf         , Rr          , Wwf         , Wwf         , Wwf         , Gg          , Gg          , Gg          , Gg          , Gg          , Gg          , Rr          , Ww^Bw\      , Ww          , Wo          , Wo          , Wo          , Wo          , Ww          , Ww          , Wwf         , Wwf         , Gg          , Gg          , Rr          , Rr          , Gs^Fds      , Gg          , Gs^Fp       
Wwf         , Wwf         , Cud         , Cud         , Rr          , Rr          , Wwf         , Rr          , Wwf         , Wwf         , Wwf         , Rr          , Chw         , Wwf         , Gg          , Wwf         , Hh          , Gg^Fp       , Gg          , Wwf         , Wwf         , Wwf         , Wwf         , Gg          , Wwf         , Gg          , Wwf         , Ww^Bw\      , Wo^Bw\      , Wo          , Wo          , Ww          , Gg          , Wwf         , Gg          , Gg          , Ss^Vhs      , Rr          , Rd^Fet      , Hh          , Mm          , Gg^Efm      , Hh          
Wwf         , Wwf         , Wwf         , Wwf         , Wwf         , Wwf         , Gg^Fp       , Wwf         , Gg^Ve       , Gg^Fp       , Gg          , Wwf         , Wwf         , Wwf         , Gs^Fet      , Gg          , Gg          , Gg          , Rb^Uf       , Rb          , Ce          , Ce          , Ce          , Wwf         , Rb          , Wwf         , Ww          , Ww          , Wo          , Wo^Bw\      , Ww^Bw\      , Ww          , Gg          , Gg          , Gg          , Gg^Fms      , Gg          , Rr          , Gg          , Hh          , Mm          , Hh          , Gs^Fms      
Ww          , Ww          , Ww          , Ww          , Xu          , Rb          , Rb^Uf       , Gg          , Hh          , Gg          , Gg          , Gg          , Gg          , Hh          , Mm          , Gg^Efm      , Gg          , Rb          , Ce          , Ce          , Rb          , Ke          , Rb          , Rb          , Gg          , Wwf         , Ww          , Wo          , Ww          , Ww          , Wwf         , Rr          , Rr          , Rr          , Rr          , Gg          , Rr          , Rr          , Gs^Fp       , Gg          , Gg          , Gg          , Gg          
Wo          , Cud         , Xu          , Uu^Uf       , Xu          , Gg          , Gg          , Mm          , Rb          , Rb^Uf       , Gg          , Gg          , Gs^Fp       , Gg^Efm      , Gg          , Gg          , Rb          , Rb          , Gs^Fms      , Gg          , Gg          , Gg          , Gg^Efm      , Gs^Fp       , Gg          , Wwf         , Wwf         , Ww          , Gg          , Ww          , Wwf         , Gg          , Gg          , Gg^Fp       , Gg          , Rr          , Gg          , Rr          , Rr          , Gg          , Rb          , Rb          , Rb          
Wo          , Cud         , Cud         , Xu          , Gg          , Gg          , Gg          , Gg          , Gs^Fp       , Gg^Efm      , Gg          , Gg          , Hh          , Gg          , Gg          , Rb          , Gg          , Gg          , Gg          , Hh          , Gg          , Gg          , Gs^Fp       , Hh          , Wwf         , Gg          , Wwf         , Gg          , Gs^Fp       , Wwf         , Wwf         , Gg          , Gg          , Gg          , Gg          , Gg          , Hh^Fp       , Gg          , Rr          , Rd^Fp       , Rb          , Ss          , Ss          
Wo          , Wo          , Cud         , Xu          , Rb          , Gg          , Hh          , Gg          , Ss          , Gs^Fms      , Mm          , Gg          , Gg          , Gg          , Gg^Ve       , Rb          , Gg          , Gg          , Ss          , Gg          , Gg          , Chr         , Chw         , Wwf         , Ww          , Wwf         , Ww          , Gg          , Gg          , Gg          , Wwf         , Wwf         , Gg          , Mm          , Hh          , Gg          , Gg          , Hh          , Rr          , Gg          , Rb          , Gg          , Gg          
Ww          , Ww          , Wwf         , Cud         , Rb^Fp       , Rr          , Rr          , Gg          , Gg          , Mm          , Chr         , Hh          , Gg          , Gg          , Gg          , Rb          , Gg          , Hh          , Gg^Fms      , Gg^Efm      , Gg          , Gg^Ve       , Wwf         , Ww          , Wo          , Ww          , Wo          , Ww          , Ww          , Ww^Vm       , Wwf         , Gg          , Gg          , Hh          , Mm          , Gs^Fms      , Gg          , Rr          , Gg          , Gg          , Gg^Ve       , Rb          , Rb          
Wwf         , Wwf         , Gg          , Rb          , Rb^Uf       , Chs         , Chr         , Gg          , Gg          , Gg          , Gs^Fms      , Gg          , Gg          , Gg          , Rb          , Rb          , Gg          , Mm          , Hh          , Ss          , Gg          , Wwf         , Ww          , Ww          , Wo          , Wo          , Ww          , Ww          , Gg          , Wwf         , Gg          , Gg          , Gg          , Gg          , Gg          , Gg^Efm      , Gg          , Rr          , Hh          , Gg          , Gg          , Rb          , Hh          
Wwf         , Wwf         , Wwf         , Gg          , Hh          , Hh          , Chr         , Gg^Efm      , Ss          , Gg          , Gg          , Gg          , Rb          , Rb          , Gg          , Rb          , Gg          , Gg ^Fet     , Gg^Uf       , Gg          , Wwf         , Wwf         , Wwf         , Ww          , Ww          , Wo          , Ww          , Gg          , Gg          , Gg          , Gg^Fp       , Hh          , Gg          , Gs^Fms      , Gg          , Gg          , Rr          , Rr          , Mm          , Gs^Fet      , Gg^Efm      , Mm          , Hh          
Ww          , Ww          , Ur          , Wwf         , Ww          , Gs^Fp       , Gg          , Mm          , Hh          , Ss          , Gg          , Rb          , Gg          , Gg          , Chr         , Rb          , Rb          , Hh          , Gg          , Gg          , Wwf         , Ww          , Ww          , Wwf         , Wwf         , Ww          , Wwf         , Ww          , Ww          , Gg^Fp       , Ww          , Ww          , Ww          , Gg          , Wwf         , Rr          , Gg          , Gg          , Gg          , Hh          , Gg          , Gg          , Gs^Fds      
Uu^Uf       , Uu^Uf       , Ur          , Wwf         , Wwf         , Ww          , Ww          , Gg          , Gs^Fp       , Gg          , Rb          , Rb          , Gg          , Chs         , Gg          , Gg          , Rb          , Gg          , Gg          , Gg          , Ww          , Ww          , Wo          , Ww          , Wwf         , Wwf         , Gs          , Gs          , Ke          , Ww          , Wwf         , Ww          , Wwf         , Wwf         , Ww          , Gg          , Gg          , Gs^Fp       , Gg          , Gg^Ve       , Gg          , Gs^Fms      , Gs^Fds      
Uh          , Uh          , Uu^Vu       , Ur          , Xu          , Wwf         , Ww          , Gg          , Gg          , Rb          , Rb          , Gg          , Gs^Fp       , Gg^Uf       , Hh          , Gs^Fms      , Gg          , Rb          , Rb          , Ww          , Wo          , Ww^Vm       , Ww          , Ww          , Wwf         , Gs          , Hh^Fms      , Ce          , Ce          , Ce          , Rr          , Wwf         , Wwf         , Ww          , Ww          , Ww          , Gg          , Ss          , Rb          , Gg          , Gg          , Gg          , Hh          
Wwf         , Wwf         , Cud         , Xu          , Xu          , Gg          , Gg          , Ww          , Gg          , Gg          , Rb          , Gg          , Gg          , Ss          , Gg          , Gg          , Ww          , Gg          , Ww          , Wo^Bw\      , Wo^Bw\      , Ww          , Gs          , Wwf         , Gs          , Gs          , Gs          , Ce          , Rr          , Rr          , Gs^Vht      , Hh^Fp       , Hh          , Wwf         , Ww          , Ww          , Ww          , Gg          , Rb          , Rb          , Gg          , Gg          , Mm          
Ur          , Ur          , Wwf         , Xu          , Xu          , Gg          , Ww          , Ww          , Gg          , Rb          , Gg          , Gg^Ve       , Gg          , Gg          , Ww          , Ww          , Wo          , Ww          , Wo          , Wo          , Ww          , Gs          , Gs          , Gs          , Hh^Vc       , Hh^Fp       , Rr          , Rr          , Hh          , Re^Uf       , Re^Fp       , Gs          , Gs          , Wwf         , Ww          , Wo          , Ww          , Gg          , Gg          , Gs^Fet      , Hh          , Rb          , Rb          
Wwf         , Wwf         , Uu^Uf       , Cud         , Cud         , Gg          , Ww          , Gg          , Rb          , Rb          , Rb          , Gs^Fds      , Hh          , Gg          , Ww          , Wo          , Wo          , Wo          , Ww          , Ww          , Hh^Fp       , Hh          , Gs          , Gs          , Gs          , Rr          , Hh^Fp       , Mm          , Re^Uf       , Mm          , Gs          , Gs          , Gs          , Ww          , Wo          , Wo          , Ww          , Gg^Fp       , Gg          , Mm          , Hh          , Gg          , Gg          
Ur          , Ur          , Uh          , Xu          , Ur          , Wwf         , Wwf         , Rb          , Gg          , Gg          , Rb          , Chr         , Gg          , Ww          , Wo          , Wo          , Ww          , Wo          , Ww          , Wwf         , Gs          , Mm          , Rr          , Rr          , Rr          , Rr          , Gs          , Re          , Gs^Fp       , Hh          , Gs          , Gs          , Ww^Vm       , Ww          , Wo          , Ww          , Gg          , Gg^Ve       , Gg          , Gg^Efm      , Ss          , Gg          , Gg          
Rb          , Rb          , Rb          , Ur          , Ur          , Wwf         , Ww          , Gg          , Gg          , Gs^Fp       , Rb          , Gg          , Gg^Ve       , Ww          , Ww          , Ww          , Hh^Fp       , Ww          , Wwf         , Wwf         , Rr          , Rr          , Re^Fp       , Hh          , Gs          , Gs          , Gs^Vht      , Gs          , Gs          , Gs          , Gs          , Gs          , Wo^Bw\      , Wo          , Ww          , Ww          , Gg          , Hh          , Gg          , Ss          , Gg          , Gg          , Gs^Fp       
Uh          , Ur          , Rb          , Rb          , Ur          , Wwf         , Wwf         , Ww          , Gg          , Gg          , Rb          , Gg          , Wwf         , Ww          , Gs          , Re^Fp       , Re^Uf       , Mm          , Gs          , Gs          , Rr          , Re^Uf       , Ce          , Gs          , Gs          , Hh          , Re^Fp       , Gs          , Gs          , Gs          , Wwf         , Wwf         , Ww          , Wo^Bw\      , Ke          , Gg          , Hh          , Gs^Fms      , Gg          , Gg          , Hh          , Gg          , Rb          
Uu          , Uu^Vu       , Rb          , Ur          , Cud         , Xu          , Gg          , Wwf         , Wwf         , Ce          , Ce          , Gg          , Ww          , Wwf         , Gs          , Gs^Vht      , Gs          , Hh          , Gs          , Rr          , Ce          , Ce          , Gd          , Gs          , Gs          , Re          , Re^Uf       , Mm          , Hh          , Gs^Vht      , Wwf         , Ww          , Ce          , Ce          , Ce          , Gs^Fds      , Gg          , Gg          , Ss          , Mm          , Rb          , Rb          , Mm          
Wwf         , Wwf         , Ur          , Uu          , Cud         , Xu          , Gg          , Wwf         , Wwf         , Ce          , Ce          , Ww          , Ww          , Wwf         , Wwf         , Gs          , Gs          , Gs          , Gs          , Rr          , Gs          , Re^Uf       , Gs          , Gs          , Gs          , Gs          , Gs          , Hh          , Re^Fp       , Gs          , Wwf         , Gg          , Ce          , Ce          , Rb          , Rb          , Gg          , Gs^Fms      , Hh          , Rb          , Gg          , Hh          , Hh          
Uu^Uf       , Ur          , Ur          , Ur          , Xu          , Rb          , Gg          , Gg          , Wwf         , Ce          , Ke          , Ww          , Wo          , Ww          , Wwf         , Hh^Fp       , Re^Uf       , Re^Fp       , Gs          , Rr          , Gs          , Gs          , Gs          , Ss          , Ce          , Gd          , Gd          , Gs          , Gs          , Gs          , Wwf         , Gg          , Gg          , Gs^Fet      , Gg          , Gg          , Gg          , Gg          , Gg          , Rb          , Rb          , Gg          , Gs^Fp       
Ur          , Ur          , Ur          , Uu^Uf       , Xu          , Gg^Vc       , Gg          , Wwf         , Ww          , Rb          , Gg          , Ww          , Ww          , Ww          , Re^Fp       , Ss          , Re          , Hh^Vc       , Hh          , Rr          , Rr          , Gs          , Ce          , Ce          , Mm          , Mm          , Hh          , Gs          , Gs          , Wwf         , Wwf         , Wwf         , Wwf         , Gg          , Hh          , Gg^Efm      , Hh          , Gs^Fp       , Gg          , Gg          , Rb          , Gg          , Gg          
Cud         , Cud         , Xu          , Ur          , Xu          , Rb          , Gg          , Wwf         , Ww          , Gg          , Ww          , Ww          , Gs          , Re          , Gs          , Re          , Mm          , Re          , Re          , Gs          , Rr          , Gs          , Gs          , Hh^Fp       , Re^Uf       , Hh          , Mm          , Gs          , Wwf         , Wwf         , Gg          , Gg          , Wwf         , Gg^Ve       , Gg          , Gs^Fp       , Gg          , Mm          , Gg          , Rb          , Gg^Fp       , Gg          , Gs^Fp       
Wo          , Wwf         , Xu          , Rb          , Cud         , Xu          , Gg          , Wwf         , Ww^Vm       , Ww          , Ww          , Ww          , Ww          , Gs          , Ww          , Gs          , Hh^Fp       , Hh          , Gs          , Gs          , Rr          , Gs          , Gs          , Re          , Ss          , Re          , Hh^Fds      , Wwf         , Wwf         , Wwf         , Gg^Fms      , Mm          , Hh          , Wwf         , Wwf         , Gg          , Gg          , Gg          , Gg          , Rb          , Rb          , Mm          , Mm          
Wo          , Wwf         , Uu^Uf       , Rb          , Xu          , Xu          , Gg          , Wwf         , Ww          , Ww          , Ww          , Ww          , Ww          , Ww          , Ww^Vm       , Gs          , Gs          , Gs          , Gd          , Gs^Vht      , Gs          , Rr          , Gs          , Ss          , Gs          , Gs          , Wwf         , Wwf         , Wwf         , Wwf         , Wwf         , Hh          , Gg          , Gg          , Wwf         , Wwf         , Wwf         , Gg          , Gg          , Gg^Fp       , Rb          , Hh          , Hh          
Ur          , Ur          , Uu          , Uu^Vu       , Xu          , Gg          , Wwf         , Wwf         , Ww          , Wo          , Wo          , Wo          , Ww          , Ww          , Ww          , Ww          , Ww          , Ce          , Ke          , Ce          , Ce          , Rr          , Gs          , Gs^Fp       , Gs          , Wwf         , Wwf         , Wwf         , Rr          , Wwf         , Wwf         , Gg          , Gg          , Gg          , Wwf         , Gg          , Gg          , Wwf         , Gg          , Gg^Ve       , Gg          , Rb          , Rb          
Ur          , Ur          , Wwf         , Wwf         , Wwf         , Wwf         , Ww          , Ww          , Wo          , Wo          , Wo          , Wo          , Wo          , Ww          , Wo          , Ww          , Ww          , Gs          , Gs          , Ce          , Wwf         , Rr          , Rr          , Gs          , Rr          , Wwf         , Wwf         , Ss^Vhs      , Ss          , Rr          , Ce          , Gg          , Gg^Fp       , Gg          , Wwf         , Gs^Fds      , Gg          , Wwf         , Wwf         , Gg          , Gg          , Gs^Fp       , Gs^Fp       
Wwf         , Wwf         , Xu          , Xu          , Gg          , Gg          , Ww          , Wo          , Wo          , Wo          , Wo          , Wo          , Wo          , Wo          , Ww          , Wo          , Wo^Bw/      , Ww^Bw/      , Ww          , Wwf         , Wwf         , Wwf         , Wwf         , Rr          , Wwf         , Wwf         , Wwf         , Hh^Fds      , Ke          , Ce          , Ce          , Gg^Fms      , Mm          , Wwf         , Gg          , Gg          , Ss          , Gg          , Gg          , Wwf         , Wwf         , Xu          , Xu          
Rr          , Rr          , Gg          , Gg          , Gg          , Gg          , Ww          , Wo          , Wo          , Wo          , Ww          , Ww          , Ww          , Ww          , Gg          , Ww^Bw/      , Ww          , Wo          , Ww          , Gg^Fp       , Gg          , Wwf         , Wwf         , Wwf         , Wwf         , Wwf         , Wwf         , Rr          , Ce          , Ce          , Mm          , Hh          , Wwf         , Wwf         , Gg          , Ss          , Xu          , Gs^Fms      , Gg          , Wwf         , Wwf         , Xu          , Xu          
Gg          , Rr          , Rr          , Gg^Fp       , Ww          , Ww          , Ww          , Wo          , Ww          , Ww          , Wwf         , Gg          , Gg          , Gg          , Gg          , Gg          , Ww          , Wo          , Ww          , Gg^Ve       , Ww          , Ww          , Gg          , Wwf         , Gg          , Wwf         , Gg^Ve       , Rr          , Rr          , Gg^Efm      , Gg^Fp       , Hh          , Wwf         , Gg          , Gg          , Gg          , Xu          , Xu          , Cud         , Gg          , Xu          , Wwf         , Wwf         
Gg^Fms      , Gg          , Rr          , Gg          , Gg          , Ww          , Wo          , Wo          , Ww          , Wwf         , Gg          , Gg          , Gg          , Gg          , Ww          , Ww          , Ww          , Wo          , Ww          , Ww          , Gg          , Gg          , Gg          , Gg          , Gg          , Hh          , Gg          , Gg^Fet      , Gg          , Rr          , Gg          , Wwf         , Gg^Fp       , Gg          , Ss          , Gg^Efm      , Xu          , Cud         , Wwf         , Xu          , Xu          , Cud         , Uh          
Gg          , Gg^Fp       , Gg          , Rr          , Wwf         , Ww          , Ww          , Ww          , Wwf         , Wwf         , Gg          , Gs^Fp       , Ss^Vhs      , Gg          , Ww          , Gg          , Gg          , Ww          , Ww          , Gg          , Gg          , Gg          , Hh          , Gs^Fp       , Gg          , Gg          , Gg          , Gg          , Gs^Fp       , Rr          , Wwf         , Wwf         , Gg          , Ss          , Xu          , Xu          , Rr          , Rr          , Uu^Vu       , Cud         , Xu          , Cud         , Rr          
Gg^Fp       , Gg          , Ch          , Ch          , Wwf         , Ww^Vm       , Wwf         , Wwf         , Gg          , Gg          , Gg          , Ss          , Gg          , Gg          , Wwf         , Gg          , Gg^Ve       , Gg          , Gg          , Wwf         , Gg          , Gs^Fp       , Ss          , Mm          , Gg^Efm      , Gg          , Gg          , Gg          , Gg          , Gg          , Wwf         , Wwf         , Gg          , Xu          , Xu          , Cud         , Ur          , Ur          , Ur          , Ur          , Xu          , Wwf         , Uh          
Gg          , Gg          , Wwf         , Ch          , Ch          , Wwf         , Ch          , Ch          , Gg          , Gg          , Gg          , Gg          , Wwf         , Wwf         , Gg          , Gg          , Gg          , Gg          , Gg          , Wwf         , Gg          , Gg          , Rb          , Rb          , Ss          , Gg          , Gg^Ve       , Gg          , Gg          , Ww          , Gg          , Gg          , Xu          , Rr          , Ur          , Ur          , Ur          , Cud         , Uu^Uf       , Wwf         , Wwf         , Wwf         , Ww          
Wwf         , Wwf         , Gg          , 2 Kh        , Ch          , Ch          , Gg^Efm      , Gg          , Gs^Fms      , Hh          , Gg          , Gg          , Wwf         , Gg          , Rb          , Gs^Fp       , Ss          , Gg          , Gg          , Wwf         , Wwf         , Gg          , Gg          , Rb          , Gs^Fms      , Hh          , Gg          , Gg          , Gg          , Ww          , Gg          , Xu          , Uu^Uf       , Rr          , Rr          , Ur          , Ur          , Wwf         , Wwf         , Wwf         , Uu^Uf       , Xu          , Xu          
Gs^Fp       , Gg^Fet      , Wwf         , Wwf         , Gg^Fet      , Hh          , Gg^Efm      , Gg^Ve       , Gg          , Gg          , Wwf         , Wwf         , Gg          , Gg^Fp       , Gg^Efm      , Ss          , Mm          , Hh          , Gs^Fet      , Gg          , Wwf         , Gg          , Hh          , Gg          , Gg          , Gg          , Hh          , Gg          , Ww          , Ww          , Gg          , Rr          , Rr          , Rr          , Uh          , Ur          , Uu^Vu       , Ur          , Wwf         , Ss^Vhs      , Cud         , Ur          , Ur          
Gs^Fp       , Gs^Fp       , Wwf         , Mm          , Gs^Fp       , Mm          , Hh          , Gg^Efm      , Mm          , Hh          , Wwf         , Wwf         , Gg          , Mm          , Hh          , Hh          , Mm          , Hh          , Gs^Fp       , Gg          , Wwf         , Mm          , Hh          , Gs^Fp       , Mm          , Mm          , Ss          , Gg          , Ww          , Gg          , Gg          , Xu          , Xu          , Cud         , Xu          , Ur          , Uh          , Cud         , Wwf         , Wwf         , Xu          , Xu          , Ur          
