border_size=1
usage=map

Mm^Xm       , Mm^Xm       , Mm          , Hh          , Mm          , Hh          , Hh          , Gg          , Re          , Re          , Gg          , Wwf         , Wwf         , Gg          , Mm          , Hh          , Gs^Fp       , Gs^Fp       , Gg          , Wwf         , Hh          , Ce          , Hh          , Wwf         , Gg          , Gs^Fp       , Mm          , Hh          , Gs^Fp       , Gg          , Wwf         , Wwf         , Gg          , Re          , Re          , Gg          , Hh          , Hh          , Mm          , Hh          , Mm          , Mm          , Mm^Xm       
Mm          , Mm^Xm       , Mm          , Mm          , Hh          , Hh          , Re          , Re^Uf       , Mm          , Gs^Fp       , Hh          , Gg          , Wwf         , Gg          , Gg          , Hh          , Gg^Efm      , Hh          , Gg          , Wwf         , Wwf         , Ce          , Wwf         , Wwf         , Gg          , Hh          , Gg          , Hh          , Gg          , Gg          , Wwf         , Gg          , Hh          , Gs^Fp       , Mm          , Re^Uf       , Re          , Hh          , Hh          , Mm          , Mm          , Mm^Xm       , Mm^Xm       
Mm^Xm       , Mm^Xm       , Mm          , Mm          , Hh          , Gg          , Re          , Gs          , Gs          , Hh          , Gs          , Gg          , Gg          , Wwf         , Wwf         , Gg          , Gg          , Gg          , Gg          , Gs^Fp       , Gg          , Wwf         , Gg          , Gs^Fp       , Gg^Efm      , Gg          , Gg          , Gg          , Wwf         , Wwf         , Gg          , Gg          , Gs          , Hh          , Gs          , Gs          , Re          , Gg          , Hh          , Mm          , Mm          , Mm^Xm       , Mm          
Mm          , Mm          , Mm          , Gs^Fp       , Gs^Fp       , Gs^Fp       , Re          , Gs^Fp       , Gs          , Gs          , Gs^Fp       , Gg          , Gg          , Gg          , Gg          , Wwf         , Wwf         , Gg          , Ce          , Gg          , Gg          , Wwf         , Gg          , Gg          , Ce          , Gg          , Wwf         , Wwf         , Gg          , Gg          , Gg          , Gg          , Gs^Fp       , Gs          , Gs          , Gs^Fp       , Re          , Gs^Fp       , Gs^Fp       , Gs^Fp       , Mm          , Mm^Xm       , Mm          
Hh          , Gs^Fp       , Gs^Fp       , Hh          , Re          , Re          , Gs^Fp       , Hh          , Gs^Vh       , Gs          , Gg          , Gg          , Gg          , Gg          , Gg          , Gg          , Wwf         , Gg          , Gs^Fp       , Gs^Fp       , Wwf         , Wwf         , Wwf         , Gs^Fp       , Gs^Fp       , Gg          , Wwf         , Gg          , Gg          , Gg          , Gg          , Gg          , Gg          , Gs          , Gs^Vh       , Hh          , Gs^Fp       , Re          , Re          , Hh          , Gs^Fp       , Gs^Fp       , Hh          
Gs^Fp       , Gs^Fp       , Re          , Re          , Gs^Fp       , Re          , Re          , Re          , Re          , Gg          , Gg          , Gg          , Re          , Hh          , Gs^Fp       , Ss^Vhs      , Gg          , Wwf         , Wwf         , Wwf         , Wwf         , Hh          , Wwf         , Wwf         , Wwf         , Wwf         , Gg^Efm      , Ss^Vhs      , Gs^Fp       , Hh          , Re          , Gg          , Gg          , Gg          , Re          , Re          , Re          , Re          , Gs^Fp       , Re          , Re          , Gs^Fp       , Gs^Fp       
Gs^Fp       , Gs^Fp       , Ce          , Gs^Fp       , Gs^Fp       , Mm          , Gs^Fp       , Gs^Fp       , Hh          , Re          , Re          , Re          , Gs^Fp       , Mm          , Gs          , Gs          , Gg          , Gg          , Hh          , Mm          , Ce          , Wwf         , Ce          , Mm          , Hh          , Gg          , Gg          , Gs          , Gs          , Mm          , Gs^Fp       , Re          , Re          , Re          , Hh          , Gs          , Gs^Fp       , Mm          , Gs^Fp       , Gs^Fp       , Ce          , Gs^Fp       , Gs^Fp       
Ce          , Ce          , 1 Ke        , Gs^Fp       , Gs          , Hh          , Gs          , Hh          , Mm          , Gs^Fp       , Ke          , Ce          , Gg          , Gs          , Re^Uf       , Gg          , Gg          , Gg          , Gg^Efm      , Hh          , Wwf         , Wwf         , Wwf         , Hh          , Gg          , Gg          , Gg          , Gg          , Re^Uf       , Gs          , Gg          , Ce          , Ke          , Gs^Fp       , Mm          , Gs^Fp       , Hh          , Hh          , Gs          , Gs^Fp       , 2 Ke        , Ce          , Ce          
Ce          , Ce          , Ce          , Rr          , Rr          , Gs^Fp       , Mm^Vhh      , Gs          , Gs          , Hh          , Gg          , Ce          , Gg          , Hh          , Mm          , Re          , Gg^Ve       , Gg          , Wwf         , Wwf         , Gs^Fp       , Ww          , Gs^Fp       , Wwf         , Wwf         , Gg          , Gg^Ve       , Re          , Mm          , Hh          , Gg          , Ce          , Gg          , Hh          , Gs          , Gs          , Mm^Vhh      , Gs^Fp       , Rr          , Rr          , Ce          , Ce          , Ce          
Ce          , Ce          , Gs^Fp       , Gs^Fp       , Rr          , Hh          , Gs^Fp       , Re^Uf       , Gg          , Gg          , Gg          , Gg          , Gg          , Hh          , Gs^Fp       , Gg          , Wwf         , Wwf         , Gg          , Gg          , Gs          , Wwf         , Gs          , Gs          , Gg          , Wwf         , Wwf         , Gg          , Gs^Fp       , Hh          , Gg          , Gg          , Gg          , Gs          , Gs          , Re^Uf       , Gs^Fp       , Gs          , Rr          , Gs^Fp       , Gs^Fp       , Ce          , Ce          
Wwf         , Wwf         , Gs          , Gs          , Gs^Fp       , Rr          , Rr          , Gs          , Gs^Fp       , Hh          , Gs          , Gg          , Gs^Fp       , Gg          , Gg          , Gg          , Wwf         , Gg          , Gg          , Gg          , Gs          , Wwf         , Gs          , Gg          , Gg          , Gg          , Wwf         , Gg          , Gg          , Gs          , Gs^Fp       , Gs          , Gs          , Hh          , Gs^Fp       , Gs          , Rr          , Rr          , Gs^Fp       , Gs          , Gs          , Wwf         , Wwf         
Gg          , Wwf         , Wwf         , Gs^Fp       , Gs          , Hh          , Gs          , Rr          , Rr          , Gs^Fp       , Rr          , Ke          , Wwf         , Wwf         , Wwf         , Wwf         , Gg          , Gg          , Mm          , Gs          , Hh          , Wwf         , Hh          , Gs          , Mm          , Gg          , Gg          , Wwf         , Wwf         , Wwf         , Wwf         , Ke          , Rr          , Gs^Fp       , Rr          , Rr          , Gs^Efm      , Hh          , Gs          , Gs^Fp       , Wwf         , Wwf         , Wwf         
Wwf         , Wwf         , Gg          , Wwf         , Gs^Fp       , Gs^Fp       , Mm          , Hh          , Gs^Fp       , Rr          , Gs^Fp       , Ce          , Ke          , Re          , Gg^Vh       , Gg          , Hh          , Hh          , Mm^Xm       , Mm^Xm       , Wwf         , Wwf         , Wwf         , Mm^Xm       , Mm^Xm       , Hh          , Hh          , Gg          , Gg^Vh       , Re          , Ke          , Ce          , Gs^Fp       , Rr          , Gs^Fp       , Hh          , Mm          , Gs^Fp       , Gs^Fp       , Wwf         , Gs          , Gs^Fp       , Gs^Fp       
Gs^Fp       , Gs^Fp       , Gg          , Wwf         , Wwf         , Gs^Fp       , Gs          , Gs          , Gg^Efm      , Gs          , Gg          , Gg          , Re          , Re          , Gg          , Gg          , Mm^Xm       , Mm^Xm       , Gs^Fp       , Wwf         , Ww          , Ww          , Ww          , Wwf         , Gs^Fp       , Mm^Xm       , Mm^Xm       , Gg          , Gg          , Re          , Re          , Gg          , Gg          , Gs          , Gg          , Gg^Efm      , Gg          , Gs^Fp       , Wwf         , Wwf         , Wwf         , Gs^Fp       , Hh          
Gs^Fp       , Gs^Fp       , Gg          , Gg^Fp       , Wwf         , Wwf         , Hh          , Mm          , Hh          , Gg          , Hh          , Gs^Fp       , Gg          , Gg          , Gs^Fp       , Gg          , Mm          , Mm^Xm       , Wwf         , Wwf         , Ww          , Ww          , Ww          , Wwf         , Wwf         , Mm^Xm       , Mm          , Gg          , Gs^Fp       , Gg          , Gg          , Gs^Fp       , Hh          , Gg          , Hh          , Mm          , Hh          , Wwf         , Wwf         , Gs^Fp       , Gg^Efm      , Wwf         , Wwf         
Re          , Re          , Gg          , Gg^Ve       , Wwf         , Hh          , Mm          , Gs^Fp       , Gs^Fp       , Gg          , Gg^Ve       , Gg          , Gg          , Gg          , Gg          , Gg^Efm      , Wwf         , Wwf         , Ww          , Ww          , Wo          , Wo          , Wo          , Ww          , Ww          , Wwf         , Wwf         , Gg          , Gg          , Gg          , Gg          , Gg          , Gg^Ve       , Gg          , Gs^Fp       , Gs^Fp       , Mm          , Hh          , Wwf         , Gg^Ve       , Gg          , Gg          , Re          
Hh          , Gs          , Gs^Fp       , Gg          , Gg          , Wwf         , Wwf         , Re          , Re          , Re          , Re          , Wwf         , Wwf         , Gg          , Hh          , Ss^Vhs      , Wwf         , Ww          , Ww          , Wo          , Wo          , Wo          , Wo          , Wo          , Ww          , Ww          , Wwf         , Ss^Vhs      , Hh          , Gg          , Wwf         , Wwf         , Re          , Re          , Re          , Re          , Wwf         , Wwf         , Gs^Fp       , Gg          , Gs^Fp       , Re          , Gg          
Re^Uf       , Re          , Mm          , Gs^Fp       , Gg          , Gg          , Ww          , Hh          , Gs          , Gs^Fp       , Re          , Re          , Wwf         , Mm          , Mm^Xm       , Wwf         , Rr          , Wwf         , Wwf         , Ww          , Wo          , Mm^Xm       , Wo          , Ww          , Wwf         , Wwf         , Rr          , Wwf         , Mm^Xm       , Mm          , Wwf         , Re          , Re          , Gs^Fp       , Gs          , Hh          , Ww          , Gg          , Gg          , Hh          , Mm          , Re          , Hh          
Re^Uf       , Re          , Re          , Hh          , Gg          , Gg          , Ww          , Gs^Fp       , Gg          , Gg          , Re          , Hh          , Mm          , Wwf         , Wwf         , Wwf         , Mm^Xm       , Gs^Fp       , Wwf         , Ww          , Ww          , Wo          , Ww          , Ww          , Wwf         , Gs^Fp       , Mm^Xm       , Wwf         , Wwf         , Wwf         , Mm          , Hh          , Re          , Gg          , Gg          , Gs^Fp       , Ww          , Gg          , Gg          , Gs^Fp       , Re          , Re          , Re          
Gs^Fp       , Gs^Fp       , Gs^Fp       , Gs          , Gg          , Ww          , Gg          , Hh          , Gg          , Re          , Re          , Hh          , Wwf         , Wwf         , Gs^Uf       , Ke          , Ce          , Ce          , Hh          , Wwf         , Ww          , Ww          , Ww          , Wwf         , Hh          , Ce          , Ce          , Ke          , Gs^Uf       , Wwf         , Wwf         , Hh          , Re          , Re          , Gg          , Hh          , Gg          , Ww          , Gg          , Re          , Gs^Fp       , Gs^Fp       , Gs^Fp       
Mm          , Hh          , Re^Uf       , Gg          , Gg          , Wwf         , Wwf         , Gg          , Gg          , Gg          , Wwf         , Wwf         , Ss^Vhs      , Wwf         , Gs^Fp       , Hh          , Ce          , Mm^Xm       , Wwf         , Wwf         , Wwf         , Wwf         , Wwf         , Wwf         , Wwf         , Mm^Xm       , Ce          , Hh          , Gs^Fp       , Wwf         , Ss^Vhs      , Wwf         , Wwf         , Gg          , Gg          , Gg          , Wwf         , Wwf         , Gg          , Gg          , Re^Uf       , Hh          , Hh          
Gs^Fp       , Gs^Fp       , Re          , Re          , Re          , Gg^Ve       , Gg          , Ww          , Ww          , Ww          , Ww          , Gg          , Ss          , Gg^Efm      , Ss          , Ce          , Ss          , Wwf         , Mm^Xm       , Gs^Fp       , Hh          , Hh          , Hh          , Gs^Fp       , Mm^Xm       , Wwf         , Ss          , Ce          , Ss          , Gg^Efm      , Ss          , Gg          , Ww          , Ww          , Ww          , Ww          , Gg          , Gg^Ve       , Re          , Re          , Re          , Gs^Fp       , Gs^Fp       
Mm          , Hh          , Gs^Fp       , Mm          , Hh          , Re          , Gs^Fp       , Gg          , Gs^Fp       , Gs^Fp       , Ww          , Gs^Fp       , Mm          , Ss          , Gs^Fp       , Ss          , Mm^Xm       , Hh          , Mm^Xm       , Mm^Xm       , Mm^Xm       , Mm^Xm       , Mm^Xm       , Mm^Xm       , Mm^Xm       , Hh          , Mm^Xm       , Ss          , Gs^Fp       , Ss          , Mm          , Gg^Fp       , Ww          , Gg^Fp       , Hh          , Gg          , Gs^Fp       , Re          , Hh          , Mm          , Hh          , Mm          , Mm          
Mm          , Mm          , Hh          , Hh          , Gs^Fp       , Re^Uf       , Hh          , Gg          , Hh          , Ww          , Hh          , Hh          , Hh          , Gs^Fp       , Hh          , Mm          , Mm^Xm       , Mm          , Mm          , Mm          , Mm^Xm       , Mm          , Mm          , Mm          , Mm^Xm       , Mm          , Mm^Xm       , Hh          , Gs^Fp       , Gs^Fp       , Hh          , Hh          , Hh          , Ww          , Gs^Fp       , Gs^Fp       , Hh          , Re^Uf       , Gs^Fp       , Mm          , Hh          , Mm          , Mm          
