border_size=1
usage=map

Ss          , Gs          , Gs          , Gs          , Ss          , Ss          , Ss          , Ss          , Gs          , Gs          , Gs          , Ss          , Ss          , Gs          , Gs          , Gs          , Ww          , Ww          , Gs          , Uh          , Xu          , Xu          , Xu          
Gs          , Gs^Ft       , Gs^Ft       , Ss          , Ss          , Ss          , Gs^Ft       , Ss          , Ss          , Gs          , Gs          , Gs^Ft       , Gs          , Ss^Vhs      , Gs          , Gs^Ft       , Ww          , Ww          , Gs^Ft       , Uh          , Xu          , Xu          , Xu          
Ww          , Ww          , Gs          , Gs          , Gs          , Gs          , Gs          , Ss          , Cud         , Ss          , Gs          , Gs          , Gs          , Gs          , Ww          , Gs          , Gs          , Gs          , Gs          , Uu^Uf       , Uu^Vu       , Xu          , Xu          
Xu          , Xu          , Gs          , Ww          , Ww          , Ww          , Ww          , Gs          , 1 Kud       , Gs          , Ww          , Ww          , Ww          , Ww          , Gs          , Gs          , Ww          , Gs          , Xu          , Rb          , Rb          , Cud         , Ss          
Xu          , Xu          , Gs          , Gs          , Gs          , Ww          , Cud         , Wo          , Cud         , Wo          , Cud         , Ww          , Gs          , Gs          , Gs          , Ww          , Ww          , Gs          , Rb          , Ss          , Rb          , Rb          , Ss          
Gs          , Gs^Ft       , Gs          , Ww          , Ww          , Gs          , Gs          , Kud         , Ww          , Kud         , Gs          , Gs          , Ww          , Ww          , Ww          , Gs          , Gs          , Gs          , Rb          , Rb          , Cud         , Rb          , Rb          
Ww          , Ww          , Ww          , Gs          , Gs          , Ww          , Gs          , Gs          , Wwf         , Gs          , Gs          , Gs          , Gs          , Gs          , Ww          , Ww          , Gs          , Xu          , Rb          , Uu^Vud      , Rb          , Rb          , Xu          
Gs          , Gs          , Ww          , Gs          , Ww          , Gs          , Gd          , Gd          , Uu^Vud      , Gd          , Gd          , Hh          , Gs          , Gs          , Gs          , Gs          , Kud         , Xu          , Xu          , Cud         , Xu          , Rb          , Xu          
Ww          , Ww          , Gs          , Ww          , Gs          , Gs          , Gd^Ft       , Xu          , Xu          , Xu          , Gd          , Gs^Ft       , Kud         , Gs          , Gs          , Cud         , Ss^Vhs      , Uh          , Ww          , Xu          , Xu          , Cud         , Ww          
Gs          , Gs          , Gs^Vht      , Gs          , Gs          , Gs          , Gs          , Cud         , Wwf         , Wwf         , Wwf         , Gs          , Cud         , Gd          , Gs          , Gd          , Gd          , Gs          , Gs          , Cud         , Wwf         , Ww          , Ww          
Ww          , Gs^Ft       , Wwf         , Cud         , Re^Uf       , Gs          , Wwf         , Wwf         , Ss^Vhs      , Gs^Ft       , Gs          , Wwf         , Cud         , Re          , Re^Ft       , Gs          , Gs          , Gs          , Ww          , Xu          , Kud         , Cud         , Xu          
Gs          , Ww          , Xu          , Kud         , Re          , Gs          , Wwf         , Gs          , Gs          , Re          , Re          , Cud         , Wwf         , Mm          , Re^Ft       , Re          , Gs          , Gs^Ft       , Hh          , Xu          , Xu          , Uh          , Xu          
Ww          , Gs^Ft       , Xu          , Re^Ft       , Re          , Gs          , Gs          , Wwf         , Wwf         , Gs          , Wwf         , Wwf         , Wwf         , Gs          , Gs          , Re          , Re^Uf       , Gd          , Kud         , Xu          , Xu          , Gs^Ft       , Gs^Ft       
Uh          , Ww          , Xu          , Cud         , Xu          , Re          , Uh          , Gs          , Gs^Ft       , Wwf         , Hh          , Hh          , Gs          , Wwf         , Gs          , Uh          , Cud         , Re^Ft       , Cud         , Re^Ft       , Xu          , Cud         , Xu          
Xu          , Uh          , Xu          , Uu^Uf       , Cud         , Xu          , Cud         , Gd          , Gs          , Wwf         , Gs          , Mm          , Hh          , Wwf         , Gs^Ft       , Gd          , Uh          , Xu          , Xu          , Uu^Uf       , Xu          , Uh          , Uh          
Gs          , Cud         , Xu          , Re^Ft       , Kud         , Re^Ft       , Re^Uf       , Uh          , Gs          , Wwf         , Wwf         , Hh          , Wwf         , Wwf         , Wwf         , Gs          , Gs          , Re          , Re          , Cud         , Xu          , Ww          , Ww          
Xu          , Gs^Ft       , Xu          , Xu          , Hh          , Gd          , Gs          , Re          , Re^Ft       , Gs          , Wwf         , Wwf         , Re          , Gs          , Gs          , Wwf         , Wwf         , Gs          , Re          , Re^Ft       , Xu          , Gs^Ft       , Gs^Ft       
Xu          , Uh          , Kud         , Xu          , Ww          , Gs^Ft       , Gs          , Re          , Re^Ft       , Mm          , Cud         , Cud         , Gs          , Re          , Ss^Vhs      , Gs          , Wwf         , Gs          , Re^Uf       , Kud         , Wwf         , Ww          , Ww          
Ww          , Cud         , Wwf         , Xu          , Gs          , Gs          , Gd          , Gs          , Gs          , Re          , Cud         , Wwf         , Wwf         , Gs^Ft       , Wwf         , Wwf         , Gs          , Gs          , Re          , Cud         , Gs^Vht      , Gs^Ft       , Gs          
Ww          , Ww          , Xu          , Cud         , Ww          , Gg          , Ss^Vhs      , Gd          , Gs          , Gd          , Kud         , Gs          , Gd          , Wwf         , Xu          , Cud         , Gd^Ft       , Gs          , Gs          , Gs          , Gs          , Gs          , Gs          
Xu          , Cud         , Xu          , Xu          , Xu          , Uh          , Kud         , Cud         , Gs          , Gs          , Gs          , Gs^Ft       , Gd          , Xu          , Uu^Vud      , Xu          , Gd          , Gs          , Ww          , Ww          , Ww          , Ww          , Ww          
Xu          , Rb          , Rb          , Cud         , Rb          , Xu          , Gs          , Gs          , Ww          , Gs          , Gs          , Hh          , Gs          , Gd          , Wwf         , Gd          , Gs          , Gs          , Gs          , Gs          , Ww          , Gs          , Gs          
Rb          , Rb          , Cud         , Uu^Vud      , Rb          , Xu          , Gs          , Ww          , Ww          , Gs          , Ww          , Gs          , Gs          , Gs          , Ww          , Gs          , Gs          , Ww          , Ww          , Gs          , Gs          , Ww          , Ww          
Ss          , Rb          , Rb          , Rb          , Rb          , Gs          , Ww          , Gs          , Gs          , Ww          , Gs          , Gs          , Cud         , 2 Kud       , Cud         , Kud         , Cud         , Gs          , Gs          , Ww          , Gs          , Gs^Ft       , Gs          
Ss          , Rb          , Rb          , Ss          , Xu          , Gs          , Ww          , Ww          , Gs          , Gs          , Ww          , Ww          , Ww          , Wo          , Kud         , Wo          , Ww          , Ww          , Ww          , Gs          , Gs          , Xu          , Xu          
Cud         , Cud         , Uu^Vu       , Rb          , Gs          , Gs          , Gs          , Gs          , Ww          , Ww          , Gs          , Ww          , Gs          , Gs          , Cud         , Gs          , Gs          , Ww          , Gs          , Ww          , Gs          , Xu          , Xu          
Xu          , Xu          , Xu          , Uu^Uf       , Gs^Ft       , Gs          , Ww          , Gs          , Gs          , Gs          , Gs          , Gs          , Gs          , Ss          , Ss          , Ss          , Gs          , Gs          , Ss          , Gs          , Gs^Ft       , Ww          , Ww          
Xu          , Xu          , Xu          , Uh          , Xu          , Ww          , Gs^Ft       , Gs          , Ss          , Ss^Vhs      , Ss          , Gs^Ft       , Gs          , Gs          , Ss          , Gs          , Gs^Ft       , Ss          , Ss          , Ss          , Ss          , Uh          , Uh          
Ww          , Ww          , Ww          , Xu          , Xu          , Xu          , Ss          , Gs          , Ss          , Xu          , Xu          , Xu          , Ss          , Ss          , Gs          , Xu          , Xu          , Xu          , Xu          , Gs^Ft       , Ss          , Xu          , Xu          
Ww          , Ww          , Ww          , Xu          , Xu          , Xu          , Ss          , Xu          , Ss          , Xu          , Xu          , Xu          , Ss          , Ss          , Gs          , Xu          , Xu          , Xu          , Xu          , Gs          , Ss          , Xu          , Xu          
