border_size=1
usage=map

Ss          , Hh          , Rp          , Ss          , Gs^Fp       , Hh          , Rp          , Rp          , Hh          , Ss          , Ss          , Gg          , Hh          , Hh          , Gs^Fms      , Ss          , Gg          , Hh          , Ww          , Ww          , Wo          , Wo          , Ww          , Wwf         , Hh          , Hh          , Hh          , Hh          , Ss          , Hh          , Hh          
Gg^Efm      , Gg^Fet      , Rp          , Mm          , Gs^Fp       , Ss          , Rp          , Gs^Fp       , Gs^Fet      , Gs^Fms      , Mm          , Gs^Fp       , Gg          , Gs^Fds      , Hh          , Gs^Fp       , Hh          , Gg          , Ww          , Wo          , Wo          , Ww          , Gs^Fp       , Gg^Fet      , Gs^Fms      , Mm          , Ss          , Mm          , Hh          , Gs^Fp       , Ss          
Gs          , Gg          , Gg          , Rp          , Rp          , Rp          , Gg          , Gs^Ve       , Gg          , Hh          , Gg          , Gg          , Re          , Gg          , Re          , Ch          , Mm          , Ww          , Wo          , Wo          , Ww          , Ww          , Mm          , Ss          , Ss^Vhs      , Hh          , Gs^Fp       , Hh          , Gs^Fms      , Gg^Fet      , Gg^Efm      
Gs^Fms      , Gs          , Gg          , Gg          , Rp          , Gg          , Gg          , Gg          , Re          , Mm          , Re          , Re          , Re          , Re          , Ch          , 1 Kh        , Ch          , Ww          , Ww          , Ww          , Gs^Fp       , Hh          , Hh          , Gs^Fp       , Gg          , Gg          , Gg          , Gs          , Gg          , Hh          , Gg^Efm      
Hh          , Gs^Fp       , Rp          , Rp          , Re^Uf       , Gs^Fds      , Re          , Re          , Gg          , Re          , Gg          , Gg          , Gg          , Kh          , Gg          , Ch          , Wwf         , Kh          , Ww^Bw\      , Gg          , Gg          , Gg          , Gg          , Gg          , Re          , Re^Uf       , Mm          , Gs          , Gs          , Gg          , Gg          
Hh          , Hh          , Rp          , Mm          , Gs^Fp       , Re          , Re          , Gg          , Gg          , Gg          , Gs          , Gg          , Gg          , Gg          , Gg          , Ww          , Ww          , Wwf         , Gg          , Gg          , Gg          , Gg          , Gg^Vh       , Gg          , Re          , Ss          , Hh          , Gs^Fp       , Re          , Gg          , Gg          
Gs^Fp       , Rp          , Mm          , Hh          , Re          , Re          , Gg          , Gg          , Gs          , Gs          , Gs^Uf       , Hh          , Hh          , Gg^Ve       , Ww          , Ww          , Ww          , Gg          , Ss          , Gs^Fp       , Gs          , Gg          , Gg          , Gg          , Gs          , Re          , Re          , Re^Uf       , Re          , Gg          , Gg          
Rp          , Rp          , Re          , Re          , Gg          , Gg          , Gg^Vh       , Gg          , Gg          , Gs^Fds      , Hh          , Mm          , Gs          , Gs^Fp       , Ww          , Wo          , Ww          , Gg          , Gs^Fp       , Ss^Vhs      , Ww          , Mm          , Hh          , Gg          , Gg^Ve       , Gs^Fms      , Gs          , Re          , Gs          , Gg          , Gg          
Re          , Re          , Gs          , Gg          , Gs^Fp       , Gg          , Gg          , Gg          , Gg          , Gs          , Gs          , Gs          , Ww          , Ww          , Wo          , Wo          , Wo          , Ww          , Ww          , Ww          , Ww          , Wwf         , Rp          , Gg          , Gg          , Gg          , Gs          , Gs          , Mm          , Gs^Uf       , Hh          
Gg^Fp       , Re          , Gs          , Hh          , Ss          , Gg^Uf       , Gg          , Gg          , Gs^Fms      , Gg^Efm      , Gg          , Gg          , Ww          , Ww          , Wo          , Wo          , Mm^Xm       , Wo          , Wo          , Wo          , Ww          , Wwf         , Wwf         , Rp          , Rp          , Gg          , Gs^Fp       , Hh          , Gs^Fet      , Hh          , Gg          
Wwf         , Gg          , Gg          , Gs^Fms      , Mm          , Hh          , Hh          , Gg          , Gg          , Mm          , Hh          , Ww          , Ww          , Wo          , Wo          , Hh          , Mm^Xm       , Wo          , Wo          , Wo          , Ww          , Gs^Fp       , Rp          , Wwf         , Wwf         , Gg          , Rp          , Rp          , Rp          , Gs          , Gg          
Rp          , Wwf         , Wwf         , Gg          , Wwf         , Wwf         , Wwf         , Rp          , Gg          , Hh          , Ww          , Ww          , Wo          , Ww          , Wwr         , Mm^Xm       , Wwr         , Wo          , Wo          , Ww          , Ww          , Gg          , Gg          , Rp          , Wwf         , Rp          , Wwf         , Wwf         , Wwf         , Rp          , Rp          
Gg          , Rp          , Rp          , Wwf         , Rp          , Rp          , Wwf         , Rp          , Rp          , Gg          , Ww          , Ww          , Wo          , Wo          , Mm^Xm       , Mm^Xm       , Wo          , Ww          , Ww          , Ww          , Hh          , Hh          , Gg          , Rp          , Hh          , Wwf         , Mm          , Gs          , Gs          , Wwf         , Wwf         
Gs^Fds      , Gg^Efm      , Gg^Fet      , Rp          , Gs^Fms      , Gg          , Rp          , Wwf         , Wwf         , Gs^Fp       , Ww          , Wo          , Wo          , Wo          , Mm^Xm       , Hh          , Wo          , Wo          , Ww          , Ww          , Gg          , Mm          , Gs^Fms      , Gg          , Gs          , Hh          , Ss          , Gs^Fp       , Gs          , Gg          , Gg^Fp       
Hh          , Hh          , Mm          , Hh          , Gs          , Gg          , Gg          , Rp          , Rp          , Wwf         , Ww          , Wo          , Ww          , Wo          , Wo          , Wo          , Wo          , Ww          , Ww          , Gg          , Gg          , Gg^Efm      , Gg          , Gg          , Gg          , Gs^Uf       , Gg^Fet      , Hh          , Gs          , Re          , Re          
Gs^Fds      , Gs^Uf       , Gs          , Gs          , Gs          , Gg          , Gg^Ve       , Gg          , Hh          , Wwf         , Ww          , Ww          , Gs^Fp       , Ww          , Ww          , Wo          , Ww          , Ww          , Gg          , Gg          , Hh          , Gg          , Gg          , Gg          , Gg^Vh       , Gg          , Gg          , Gg          , Re          , Re          , Rp          
Gg          , Gs          , Re          , Re          , Re          , Gs^Fms      , Gg          , Gg          , Gg          , Mm          , Gs          , Ss^Vhs      , Ss          , Gg          , Ww          , Wo          , Ww          , Gs^Fp       , Hh          , Mm          , Gs^Uf       , Gs^Fp       , Gg          , Gg          , Gg          , Gg          , Re          , Re          , Mm          , Rp          , Gs^Fp       
Gg          , Gg          , Re          , Re^Uf       , Hh          , Re          , Re          , Gg          , Gg^Vh       , Gg          , Gg          , Gs^Fp       , Gg          , Gg          , Ww          , Ww          , Gg          , Gg^Ve       , Gg          , Hh          , Gg          , Gg          , Gg          , Gg          , Gg^Efm      , Re          , Gs^Fds      , Hh          , Rp          , Rp          , Hh          
Gg          , Gg          , Gg          , Gs^Fp       , Mm          , Ss          , Re          , Gg          , Gg          , Gg          , Gg          , Gg          , Ww^Bw\      , Wwf         , Wwf         , Ww          , Gg          , Gg          , Gg          , Gg          , Gg          , Gg          , Gg          , Gg          , Re          , Re          , Re^Uf       , Mm          , Rp          , Hh          , Hh          
Gg^Efm      , Gg          , Gg          , Gg          , Gg          , Re^Uf       , Gs          , Gg          , Hh          , Gs          , Gs^Fp       , Gg          , Ww          , Kh          , Ch          , Ch          , Ch          , Kh          , Gg          , Gg          , Re          , Re          , Re          , Re          , Gg          , Gs^Fp       , Rp          , Rp          , Gg          , Gs^Fms      , Gg          
Gs^Fds      , Gs          , Gs^Fp       , Gs          , Gs^Fp       , Gs          , Ss^Vhs      , Gs^Fp       , Mm          , Hh          , Ww          , Ww          , Wo          , Ww          , Mm          , 2 Kh        , Re          , Re          , Re          , Re          , Gs          , Gs^Ve       , Gs          , Gg          , Gg          , Gg          , Rp          , Gg          , Gg          , Gs          , Gg          
Ss          , Gg^Fet      , Ss          , Hh          , Mm          , Hh          , Gs^Fms      , Ss          , Gs^Fp       , Ww          , Wo          , Wo          , Ww          , Ww          , Hh          , Ch          , Gs^Fds      , Gs          , Gs^Fms      , Mm          , Gs^Fet      , Hh          , Mm          , Hh          , Rp          , Rp          , Gs^Fp       , Rp          , Rp          , Gg          , Gg          
Hh          , Hh          , Gs^Fms      , Gs^Fp       , Hh          , Ss          , Mm          , Gg^Fet      , Ww          , Ww          , Wo          , Wo          , Ww          , Hh          , Gs^Fp       , Gg^Fet      , Gs^Fms      , Hh          , Mm          , Hh          , Gs^Fp       , Ss          , Hh          , Gs^Fp       , Rp          , Ss          , Ss          , Hh          , Mm          , Rp          , Gg          
Hh          , Gs^Fms      , Hh          , Ss          , Hh          , Hh          , Wwf         , Ww          , Wo          , Wo          , Ww          , Ww          , Hh          , Gg          , Hh          , Hh          , Ss          , Hh          , Hh          , Gs^Fms      , Ss          , Hh          , Rp          , Rp          , Gg          , Hh          , Hh          , Gs^Fp       , Ss          , Rp          , Hh          
