border_size=1
usage=map

_off^_usr   , _off^_usr   , _off^_usr   , _off^_usr   , _off^_usr   , _off^_usr   , _off^_usr   , _off^_usr   , _off^_usr   , _off^_usr   , _off^_usr   , _off^_usr   , _off^_usr   , _off^_usr   , _off^_usr   , _off^_usr   , _off^_usr   , _off^_usr   , _off^_usr   , _off^_usr   , _off^_usr   , _off^_usr   , _off^_usr   , _off^_usr   , _off^_usr   , _off^_usr   , _off^_usr   
_off^_usr   , _off^_usr   , _off^_usr   , _off^_usr   , _off^_usr   , _off^_usr   , _off^_usr   , _off^_usr   , _off^_usr   , _off^_usr   , _off^_usr   , _off^_usr   , _off^_usr   , _off^_usr   , _off^_usr   , _off^_usr   , _off^_usr   , _off^_usr   , Wo          , _off^_usr   , _off^_usr   , _off^_usr   , _off^_usr   , _off^_usr   , _off^_usr   , _off^_usr   , _off^_usr   
_off^_usr   , _off^_usr   , _off^_usr   , _off^_usr   , _off^_usr   , _off^_usr   , _off^_usr   , _off^_usr   , _off^_usr   , _off^_usr   , _off^_usr   , _off^_usr   , _off^_usr   , _off^_usr   , _off^_usr   , _off^_usr   , Ww          , Wo          , Wo          , Ww          , Hh          , _off^_usr   , Gg^Efm      , _off^_usr   , _off^_usr   , _off^_usr   , _off^_usr   
_off^_usr   , _off^_usr   , _off^_usr   , _off^_usr   , _off^_usr   , _off^_usr   , _off^_usr   , _off^_usr   , _off^_usr   , _off^_usr   , _off^_usr   , _off^_usr   , _off^_usr   , _off^_usr   , Gg          , Gg^Ve       , Ww          , Ww          , Wo          , Ww          , Ww          , Gs^Fp       , Hh          , Mm          , Gg^Uf       , _off^_usr   , _off^_usr   
_off^_usr   , _off^_usr   , _off^_usr   , _off^_usr   , _off^_usr   , _off^_usr   , _off^_usr   , _off^_usr   , _off^_usr   , _off^_usr   , _off^_usr   , _off^_usr   , Gg          , Gg          , Cv          , Cv          , Cv          , Ww          , Ww          , Ww          , Gs^Fp       , Mm          , Hh          , Hh          , Gs^Fms      , Hh          , _off^_usr   
_off^_usr   , _off^_usr   , _off^_usr   , _off^_usr   , _off^_usr   , _off^_usr   , _off^_usr   , _off^_usr   , _off^_usr   , _off^_usr   , Gg^Ve       , Gg          , Gg          , Gs^Fp       , Cv          , 1 Kv        , Cv          , Ww          , Ww          , Ww          , Gs^Fms      , Gg          , Ss          , Gs^Fp       , Gg^Ve       , Gg^Fet      , _off^_usr   
_off^_usr   , _off^_usr   , _off^_usr   , _off^_usr   , _off^_usr   , _off^_usr   , _off^_usr   , _off^_usr   , Gs^Fms      , Gg^Fet      , Hh          , Gg          , Rr          , Rr          , Gg          , Cv          , Ww          , Ww^Bw\      , Ww^Bw\      , Ww          , Wwf         , Gg          , Gg          , Ss          , Rd          , Rd          , _off^_usr   
_off^_usr   , _off^_usr   , _off^_usr   , _off^_usr   , _off^_usr   , _off^_usr   , Rd          , Wwf         , Wwf         , Mm          , Rr          , Rr          , Gg          , Mm          , Ww          , Ww          , Ww          , Ww          , Gg          , Gg^Efm      , Wwf         , Gg          , Rd          , Rd          , Gg^Efm      , Cv          , _off^_usr   
_off^_usr   , _off^_usr   , _off^_usr   , _off^_usr   , Cv          , Cv          , Gg^Efm      , Rd          , Wwf         , Rr          , Gs^Fp       , Gs^Fms      , Gg          , Gs^Fp       , Ww          , Ww          , Gg          , Gg          , Ss          , Gg^Efm      , Wwf         , Rd          , Rd          , Gg^Ve       , Gg^Efm      , Cv          , _off^_usr   
_off^_usr   , _off^_usr   , Gg^Fet      , Hh          , Rd          , Gg^Efm      , Gg^Ve       , Rd          , Wwf         , Hh          , Hh          , Gg^Efm      , Gg          , Gg^Ve       , Ww          , Ww          , Gg          , Cv          , Gg^Uf       , Gg^Ve       , Wwf         , Mm          , Wwf         , Rd          , Rd          , Rd          , _off^_usr   
_off^_usr   , Gg^Uf       , Gs^Fms      , Gg^Ve       , Ss          , Rd          , Rd          , Rd          , Mm          , Wwf         , Gg          , Gs^Fp       , Hh          , Ww          , Kv          , Gg          , Gg^Efm      , Gg^Efm      , Gg          , Gg          , Gg          , Wwf         , Gs^Fp       , Wwf         , Wwf         , Wwf         , _off^_usr   
_off^_usr   , Mm          , Hh          , Gs^Fp       , Ss          , Gg          , Gg          , Rd          , Wwf         , Wwf         , Gg          , Gg          , Gg          , Gg          , Gg^Fet      , Ss          , Ss^Vhs      , Gg          , Gg          , Gg          , Gs^Fms      , Hh          , Hh          , Rr          , Mm          , Hh          , _off^_usr   
_off^_usr   , Gs^Fp       , Hh          , Hh          , Gg          , Gg          , Wwf         , Wwf         , Gg^Efm      , Gg^Ve       , Gg^Uf       , Gg          , Gg          , Gg^Efm      , Hh          , Ss          , Hh          , Gg^Efm      , Gg          , Hh          , Gg          , Gg^Efm      , Gg^Fet      , Rr          , Hh          , Gs^Fp       , _off^_usr   
_off^_usr   , Gg^Efm      , Gs^Fms      , Mm          , Gs^Fp       , Gs^Fp       , Ww          , Gg^Efm      , Gg          , Ss          , Cv          , Gg          , Gg^Efm      , Ss^Vhs      , Ss          , Kv          , Ss          , Gg^Fet      , Kv          , Ww          , Gg^Ve       , Gg          , Gg          , Rr          , Gg          , Gg^Ve       , _off^_usr   
_off^_usr   , _off^_usr   , Hh          , Ww          , Ww          , Ww          , Ww          , Ww^Bw|      , Ww          , Gg          , Gg          , Gg          , Gg          , Ss          , Gg^Fet      , Hh          , Ss^Vhs      , Ss          , Gg          , Ww          , Ww          , Gs^Fp       , Mm          , Rr          , Gg          , Gg          , _off^_usr   
_off^_usr   , _off^_usr   , Ww          , Ww          , Wo          , Ww          , Ww          , Ww^Bw|      , Ww          , Ww          , Ww          , Ww          , Ww          , Kv          , Gg          , Gg^Efm      , Gg          , Gg^Efm      , Gg          , Ww          , Ww          , Ww          , Gg          , Rr          , Gs^Fp       , Gg          , _off^_usr   
_off^_usr   , _off^_usr   , Wo          , Wo          , Ww          , Ww          , Cv          , Cv          , Cv          , Ww          , Ww          , Ww          , Gg^Ve       , Ww          , Hh          , Gg          , Gg          , Gg          , Cv          , Gg          , Ww          , Ww          , Cv          , Cv          , Cv          , Gg          , _off^_usr   
_off^_usr   , _off^_usr   , _off^_usr   , Wo          , Ww          , Gg^Ve       , Cv          , 3 Kv        , Cv          , Gg          , Mm          , Gs^Fp       , Gg          , Gg          , Gs^Fp       , Gg^Efm      , Gg          , Gg^Uf       , Ss          , Gg          , Ww          , Ww          , Cv          , 2 Kv        , Cv          , Gg          , _off^_usr   
_off^_usr   , _off^_usr   , _off^_usr   , _off^_usr   , _off^_usr   , Gg          , Gg          , Cv          , Gs^Fp       , Rr          , Rr          , Gg          , Gs^Fp       , Gg^Efm      , Hh          , Hh          , Wwf         , Gg^Ve       , Gg^Efm      , Gg          , Ww^Bw/      , Ww^Bw/      , Ww          , Cv          , Gg^Ve       , Gg          , _off^_usr   
_off^_usr   , _off^_usr   , _off^_usr   , _off^_usr   , _off^_usr   , _off^_usr   , _off^_usr   , Gg          , Gg          , Gg          , Gg          , Rr          , Rr          , Gg^Fet      , Gs^Fms      , Wwf         , Mm          , Wwf         , Wwf         , Gg^Efm      , Ww          , Ww          , Ww          , Ww          , Ww          , Ww          , _off^_usr   
_off^_usr   , _off^_usr   , _off^_usr   , _off^_usr   , _off^_usr   , _off^_usr   , _off^_usr   , _off^_usr   , _off^_usr   , Gg^Ve       , Gs^Fp       , Mm          , Gs^Fp       , Rr          , Wwf         , Wwf         , Rd          , Rd          , Gg          , Wwf         , Gs^Fms      , Ww          , Ww          , Wo          , Wo          , Wo          , _off^_usr   
_off^_usr   , _off^_usr   , _off^_usr   , _off^_usr   , _off^_usr   , _off^_usr   , _off^_usr   , _off^_usr   , _off^_usr   , _off^_usr   , _off^_usr   , Hh          , Wwf         , Wwf         , Rd          , Rd          , Gg^Ve       , Rd          , Gg          , Gg          , Gg          , Gs^Fp       , Ww          , Ww          , Ww          , Wo          , _off^_usr   
_off^_usr   , _off^_usr   , _off^_usr   , _off^_usr   , _off^_usr   , _off^_usr   , _off^_usr   , _off^_usr   , _off^_usr   , _off^_usr   , _off^_usr   , _off^_usr   , _off^_usr   , Wwf         , Rd          , Gg^Efm      , Gg^Efm      , Rd          , Ss          , Ss          , Hh          , Mm          , Hh          , Hh          , _off^_usr   , _off^_usr   , _off^_usr   
_off^_usr   , _off^_usr   , _off^_usr   , _off^_usr   , _off^_usr   , _off^_usr   , _off^_usr   , _off^_usr   , _off^_usr   , _off^_usr   , _off^_usr   , _off^_usr   , _off^_usr   , _off^_usr   , _off^_usr   , Cv          , Cv          , Rd          , Gg^Ve       , Gs^Fp       , Mm          , Gs^Fms      , Gs^Fp       , _off^_usr   , _off^_usr   , _off^_usr   , _off^_usr   
_off^_usr   , _off^_usr   , _off^_usr   , _off^_usr   , _off^_usr   , _off^_usr   , _off^_usr   , _off^_usr   , _off^_usr   , _off^_usr   , _off^_usr   , _off^_usr   , _off^_usr   , _off^_usr   , _off^_usr   , _off^_usr   , _off^_usr   , Rd          , Hh          , Hh          , Gg^Fet      , Hh          , _off^_usr   , _off^_usr   , _off^_usr   , _off^_usr   , _off^_usr   
_off^_usr   , _off^_usr   , _off^_usr   , _off^_usr   , _off^_usr   , _off^_usr   , _off^_usr   , _off^_usr   , _off^_usr   , _off^_usr   , _off^_usr   , _off^_usr   , _off^_usr   , _off^_usr   , _off^_usr   , _off^_usr   , _off^_usr   , _off^_usr   , _off^_usr   , Gg^Uf       , _off^_usr   , _off^_usr   , _off^_usr   , _off^_usr   , _off^_usr   , _off^_usr   , _off^_usr   
_off^_usr   , _off^_usr   , _off^_usr   , _off^_usr   , _off^_usr   , _off^_usr   , _off^_usr   , _off^_usr   , _off^_usr   , _off^_usr   , _off^_usr   , _off^_usr   , _off^_usr   , _off^_usr   , _off^_usr   , _off^_usr   , _off^_usr   , _off^_usr   , _off^_usr   , _off^_usr   , _off^_usr   , _off^_usr   , _off^_usr   , _off^_usr   , _off^_usr   , _off^_usr   , _off^_usr   
