border_size=1
usage=map

_off^_usr   , _off^_usr   , _off^_usr   , _off^_usr   , _off^_usr   , _off^_usr   , _off^_usr   , _off^_usr   , _off^_usr   , _off^_usr   , _off^_usr   , _off^_usr   , _off^_usr   , _off^_usr   , _off^_usr   , _off^_usr   , _off^_usr   , _off^_usr   , _off^_usr   , _off^_usr   , _off^_usr   , _off^_usr   
_off^_usr   , _off^_usr   , _off^_usr   , _off^_usr   , _off^_usr   , _off^_usr   , _off^_usr   , _off^_usr   , _off^_usr   , _off^_usr   , _off^_usr   , _off^_usr   , _off^_usr   , _off^_usr   , _off^_usr   , _off^_usr   , _off^_usr   , _off^_usr   , _off^_usr   , _off^_usr   , _off^_usr   , _off^_usr   
_off^_usr   , _off^_usr   , _off^_usr   , _off^_usr   , _off^_usr   , _off^_usr   , _off^_usr   , _off^_usr   , _off^_usr   , _off^_usr   , Gs^Ft       , Ce          , Gs^Ft       , _off^_usr   , _off^_usr   , _off^_usr   , _off^_usr   , _off^_usr   , _off^_usr   , _off^_usr   , _off^_usr   , _off^_usr   
_off^_usr   , _off^_usr   , _off^_usr   , _off^_usr   , _off^_usr   , _off^_usr   , _off^_usr   , _off^_usr   , Gs          , Hh          , Ce          , 1 Ke        , Ce          , Hh          , Gs^Ft       , _off^_usr   , _off^_usr   , _off^_usr   , _off^_usr   , _off^_usr   , _off^_usr   , _off^_usr   
_off^_usr   , _off^_usr   , _off^_usr   , _off^_usr   , _off^_usr   , _off^_usr   , Gs          , Gs          , Ww          , Gs          , Re          , Ce          , Gs          , Gs^Vht      , Wwf         , Wwf         , Rr          , _off^_usr   , _off^_usr   , _off^_usr   , _off^_usr   , _off^_usr   
_off^_usr   , _off^_usr   , _off^_usr   , _off^_usr   , Rr          , Gs          , Ww          , Ww          , Ss^Vhs      , Re          , Gs^Ft       , Re          , Gs          , Wwf         , Gs          , Hh          , Gs^Ft       , Rr          , Rr          , _off^_usr   , _off^_usr   , _off^_usr   
_off^_usr   , _off^_usr   , Uu^Uf       , Rr          , Uu^Uf       , Ss^Vhs      , Ss          , Ww          , Rp          , Rp          , Rp          , Hh          , Gs          , Wwf         , Wwf         , Gs          , Uh          , Uu^Vu       , Rr          , Rr          , Uu^Uf       , _off^_usr   
_off^_usr   , _off^_usr   , Rr          , Rr          , Uu          , Xu          , Ss          , Ww          , Rp          , Gs          , Re          , Rp          , Gs          , Gs^Vht      , Gs^Ft       , Wwf         , Uu^Uf       , Xu          , Uu          , Rr          , Rr          , _off^_usr   
_off^_usr   , _off^_usr   , Rr          , Rr          , Xu          , Xu          , Mm          , Wwf         , Gs          , Gs          , Ss^Vhs      , Re          , Gs          , Gs          , Gs          , Wwf         , Mm          , Xu          , Xu          , Uu^Uf       , Rr          , _off^_usr   
_off^_usr   , _off^_usr   , Rr          , Uu^Vu       , Uh          , Uu^Uf       , Wwf         , Wwf         , Chw         , Gs          , Ww          , Gs^Ft       , Mm          , Gs          , Chw         , Wwf         , Wwf         , Ss          , Ss          , Ss^Vhs      , Gs          , _off^_usr   
_off^_usr   , _off^_usr   , Rr          , Gs^Ft       , Gs          , Wwf         , Gs^Ft       , Gs          , Gs          , Gs          , Gs^Ft       , Hh          , Gs^Ft       , Gs          , Gs          , Gs          , Rp          , Ww          , Ww          , Ww          , Gs          , _off^_usr   
_off^_usr   , _off^_usr   , Wwf         , Hh          , Gs          , Wwf         , Gs^Vht      , Gs          , Gs          , Mm          , Hh          , Ww          , Hh          , Ww          , Ss^Vhs      , Gs          , Gs          , Rp          , Ss^Vhs      , Ww          , Gs          , _off^_usr   
_off^_usr   , _off^_usr   , Gs^Ft       , Wwf         , Wwf         , Wwf         , Gs          , Gs          , Re          , Gs^Ft       , Ww          , Gs^Ft       , Mm          , Gs^Ft       , Re          , Re          , Rp          , Rp          , Re          , Ww          , Gs          , _off^_usr   
_off^_usr   , _off^_usr   , Hh          , Gs^Vht      , Gs          , Gs          , Hh          , Rp          , Re          , Ss^Vhs      , Gs          , Gs          , Gs          , Gs          , Gs          , Rp          , Hh          , Gs^Ft       , Re          , Gs          , Hh          , _off^_usr   
_off^_usr   , _off^_usr   , Gs^Ft       , Ce          , Ce          , Re          , Gs^Ft       , Rp          , Gs          , Gs          , Gs          , Chw         , Gs          , Gs          , Gs^Vht      , Gs          , Gs          , Re          , Ce          , Ce          , Gs^Ft       , _off^_usr   
_off^_usr   , _off^_usr   , Ce          , 3 Ke        , Ce          , Re          , Re          , Rp          , Rp          , Rp          , Wwf         , Wwf         , Wwf         , Gs^Ft       , Wwf         , Wwf         , Wwf         , Gs          , Ce          , 2 Ke        , Ce          , _off^_usr   
_off^_usr   , _off^_usr   , _off^_usr   , Gs^Ft       , Hh          , Gs          , Ww          , Ss^Vhs      , Ww          , Ww          , Ss          , Mm          , Uu^Uf       , Wwf         , Gs          , Gs          , Wwf         , Gs^Vht      , Hh          , Gs^Ft       , _off^_usr   , _off^_usr   
_off^_usr   , _off^_usr   , _off^_usr   , _off^_usr   , _off^_usr   , Gs          , Gs          , Ww          , Ww          , Ss          , Xu          , Xu          , Xu          , Uh          , Gs^Ft       , Hh          , Wwf         , Gs^Ft       , _off^_usr   , _off^_usr   , _off^_usr   , _off^_usr   
_off^_usr   , _off^_usr   , _off^_usr   , _off^_usr   , _off^_usr   , _off^_usr   , _off^_usr   , Gs          , Gs          , Ss^Vhs      , Uu^Uf       , Uu          , Rr          , Uu^Vu       , Rr          , Rr          , _off^_usr   , _off^_usr   , _off^_usr   , _off^_usr   , _off^_usr   , _off^_usr   
_off^_usr   , _off^_usr   , _off^_usr   , _off^_usr   , _off^_usr   , _off^_usr   , _off^_usr   , _off^_usr   , _off^_usr   , Rr          , Rr          , Rr          , Rr          , Rr          , _off^_usr   , _off^_usr   , _off^_usr   , _off^_usr   , _off^_usr   , _off^_usr   , _off^_usr   , _off^_usr   
_off^_usr   , _off^_usr   , _off^_usr   , _off^_usr   , _off^_usr   , _off^_usr   , _off^_usr   , _off^_usr   , _off^_usr   , _off^_usr   , _off^_usr   , Uu^Uf       , _off^_usr   , _off^_usr   , _off^_usr   , _off^_usr   , _off^_usr   , _off^_usr   , _off^_usr   , _off^_usr   , _off^_usr   , _off^_usr   
_off^_usr   , _off^_usr   , _off^_usr   , _off^_usr   , _off^_usr   , _off^_usr   , _off^_usr   , _off^_usr   , _off^_usr   , _off^_usr   , _off^_usr   , _off^_usr   , _off^_usr   , _off^_usr   , _off^_usr   , _off^_usr   , _off^_usr   , _off^_usr   , _off^_usr   , _off^_usr   , _off^_usr   , _off^_usr   
