border_size=1
usage=map

_off^_usr   , _off^_usr   , _off^_usr   , _off^_usr   , _off^_usr   , _off^_usr   , _off^_usr   , _off^_usr   , _off^_usr   , _off^_usr   , _off^_usr   , _off^_usr   , _off^_usr   , _off^_usr   , _off^_usr   , _off^_usr   , _off^_usr   , _off^_usr   , _off^_usr   , _off^_usr   , _off^_usr   , _off^_usr   , _off^_usr   , _off^_usr   , _off^_usr   , _off^_usr   , _off^_usr   , _off^_usr   , _off^_usr   , _off^_usr   , _off^_usr   , _off^_usr   , _off^_usr   , _off^_usr   , _off^_usr   , _off^_usr   , _off^_usr   , _off^_usr   , _off^_usr   , _off^_usr   , _off^_usr   , _off^_usr   , _off^_usr   
_off^_usr   , _off^_usr   , _off^_usr   , _off^_usr   , _off^_usr   , _off^_usr   , _off^_usr   , _off^_usr   , _off^_usr   , _off^_usr   , _off^_usr   , _off^_usr   , _off^_usr   , _off^_usr   , _off^_usr   , _off^_usr   , _off^_usr   , _off^_usr   , Gs^Vht      , Gs^Ft       , Wwf         , Wwf         , Mm          , Mm          , Chs         , _off^_usr   , _off^_usr   , _off^_usr   , _off^_usr   , _off^_usr   , _off^_usr   , _off^_usr   , _off^_usr   , _off^_usr   , _off^_usr   , _off^_usr   , _off^_usr   , _off^_usr   , _off^_usr   , _off^_usr   , _off^_usr   , _off^_usr   , _off^_usr   
_off^_usr   , _off^_usr   , _off^_usr   , _off^_usr   , _off^_usr   , _off^_usr   , _off^_usr   , _off^_usr   , _off^_usr   , _off^_usr   , _off^_usr   , _off^_usr   , _off^_usr   , _off^_usr   , _off^_usr   , _off^_usr   , Rb          , Rb          , Rb          , Wwf         , Chw         , Wwf         , Rb          , Rb          , Rb          , Ss          , Ss^Vhs      , _off^_usr   , _off^_usr   , _off^_usr   , _off^_usr   , _off^_usr   , _off^_usr   , _off^_usr   , _off^_usr   , _off^_usr   , _off^_usr   , _off^_usr   , _off^_usr   , _off^_usr   , _off^_usr   , _off^_usr   , _off^_usr   
_off^_usr   , _off^_usr   , _off^_usr   , _off^_usr   , _off^_usr   , _off^_usr   , _off^_usr   , _off^_usr   , _off^_usr   , _off^_usr   , _off^_usr   , _off^_usr   , _off^_usr   , _off^_usr   , Ss          , Rb          , Chr         , Chr         , Chr         , Chw         , Chw         , Chw         , Chr         , Chr         , Chr         , Rb          , Gs^Ft       , Gs^Ft       , Rb^Uf       , _off^_usr   , _off^_usr   , _off^_usr   , _off^_usr   , _off^_usr   , _off^_usr   , _off^_usr   , _off^_usr   , _off^_usr   , _off^_usr   , _off^_usr   , _off^_usr   , _off^_usr   , _off^_usr   
_off^_usr   , _off^_usr   , _off^_usr   , _off^_usr   , _off^_usr   , _off^_usr   , _off^_usr   , _off^_usr   , _off^_usr   , _off^_usr   , _off^_usr   , _off^_usr   , Gs^Ft       , Ss^Vhs      , Rb          , Rb          , Rb          , 1 Kh        , Chw         , Wwf         , Rb          , Wwf         , Chw         , 4 Kh        , Wwf         , Rb          , Rb          , Rb          , Rb          , Rb          , Ss^Vhs      , _off^_usr   , _off^_usr   , _off^_usr   , _off^_usr   , _off^_usr   , _off^_usr   , _off^_usr   , _off^_usr   , _off^_usr   , _off^_usr   , _off^_usr   , _off^_usr   
_off^_usr   , _off^_usr   , _off^_usr   , _off^_usr   , _off^_usr   , _off^_usr   , _off^_usr   , _off^_usr   , _off^_usr   , _off^_usr   , Gs^Fds      , Rb^Uf       , Rb          , Gs^Ft       , Rb          , Rb          , Wwf         , Wwf         , Rb          , Rb          , Rb          , Rb          , Wwf         , Wwf         , Rb          , Wwf         , Wwf         , Wwf         , Wwf         , Rb          , Wwf         , Wwf         , Wwf         , _off^_usr   , _off^_usr   , _off^_usr   , _off^_usr   , _off^_usr   , _off^_usr   , _off^_usr   , _off^_usr   , _off^_usr   , _off^_usr   
_off^_usr   , _off^_usr   , _off^_usr   , _off^_usr   , _off^_usr   , _off^_usr   , _off^_usr   , _off^_usr   , Gs^Ft       , Mm          , Mm          , Hh          , Rb          , Rb          , Rb          , Rb          , Wwf         , Rb          , Gs^Ft       , Hh          , Rb          , Rb          , Wwf         , Rb          , Rb          , Rb          , Rb          , Rb          , Wwf         , Wwf         , Rb          , Chw         , Rb          , Mm          , Gs^Ft       , _off^_usr   , _off^_usr   , _off^_usr   , _off^_usr   , _off^_usr   , _off^_usr   , _off^_usr   , _off^_usr   
_off^_usr   , _off^_usr   , _off^_usr   , _off^_usr   , _off^_usr   , _off^_usr   , Hh          , Chr         , Chw         , Rb          , Rb          , Gs^Ft       , Rb          , Rb          , Wwf         , Wwf         , Rb          , Mm^Vhh      , Rb          , Gs^Ft       , Rb          , Wwf         , Mm          , Wwf         , Rb          , Chw         , Chw         , Rb          , Rb          , Chw         , Chr         , Rb          , Rb          , Rb          , Rb          , Ss^Vhs      , Gs^Ft       , _off^_usr   , _off^_usr   , _off^_usr   , _off^_usr   , _off^_usr   , _off^_usr   
_off^_usr   , _off^_usr   , _off^_usr   , _off^_usr   , Rb          , Rb          , Rb          , Hh^Uf       , Rb          , Rb          , Rb          , Rb          , Rb          , Rb          , Wwf         , Gs^Ft       , Rb          , Rb          , Chr         , Rb          , Rb          , Wwf         , Wwf         , Wwf         , Wwf         , Rb          , Rb          , Rb          , Rb          , Rb^Uf       , Kh          , Chr         , Chr         , Chr         , Kh          , Rb          , Rb          , Rb          , Rb          , _off^_usr   , _off^_usr   , _off^_usr   , _off^_usr   
_off^_usr   , _off^_usr   , Wwf         , Rb          , Wwf         , Wwf         , Wwf         , Rb          , Rb          , Rb          , Wwf         , Ss^Vhs      , Chw         , Wwf         , Hh          , Mm          , Rb          , Rb          , Chw         , Wwf         , Wwf         , Wwf         , Ss^Vhs      , Hh          , Mm          , Wwf         , Wwf         , Rb          , Hh^Vhh      , Hh          , Rb          , Rb          , Rb          , Rb          , Rb          , Rb          , Hh          , Hh          , Rb          , Gs^Fds      , Hh          , _off^_usr   , _off^_usr   
_off^_usr   , _off^_usr   , Chw         , Wwf         , Gs^Ft       , Gs^Fds      , Gs^Vht      , Wwf         , Wwf         , Wwf         , Wwf         , Hh          , Mm          , Rb          , Rb          , Hh          , Rb          , Rb          , Kh          , Mm          , Mm^Xm       , Mm^Xm       , Hh          , Mm^Xm       , Mm^Xm       , Mm          , Hh          , Wwf         , Rb          , Gs^Ft       , Rb          , Rb          , Mm          , Hh          , Rb          , Gs^Ft       , Gs^Ft       , Mm          , Rb          , Gs^Vht      , Rb          , _off^_usr   , _off^_usr   
_off^_usr   , _off^_usr   , Wwf         , Mm          , Rb          , Rb          , Rb          , Rb          , Rb          , Rb          , Rb          , Wwf         , Wwf         , Wwf         , Wwf         , Rb          , Chw         , Chw         , Mm^Xm       , Chw         , Rp          , Rp          , Rp          , Mm^Xm       , Wwf         , Wwf         , Wwf         , Wwf         , Wwf         , Rb          , Wwf         , Wwf         , Wwf         , Wwf         , Wwf         , Rb          , Rb          , Rb          , Rb          , Rb          , Rb          , _off^_usr   , _off^_usr   
_off^_usr   , _off^_usr   , Gs^Ft       , Wwf         , Hh          , Rb          , Hh          , Chw         , Gs^Ft       , Rb          , Rb          , Rb          , Rb          , Gs^Fds      , Hh          , Wwf         , Wwf         , Mm^Xm       , Mm          , Hh          , Rb^Uf       , Rb          , Rb          , Rp          , Wwf         , Mm^Xm       , Hh          , Gs^Ft       , Rb          , Wwf         , Ss^Vhs      , Rb          , Rb          , Rb          , Gs^Ft       , Wwf         , Wwf         , Wwf         , Wwf         , Chw         , Rb^Uf       , _off^_usr   , _off^_usr   
_off^_usr   , _off^_usr   , Rb^Uf       , Wwf         , Wwf         , Gs^Ft       , Wwf         , Mm          , Gs^Fds      , Hh          , Rb          , Rb          , Ss^Vhs      , Rb          , Rb          , Rb          , Hh          , Wwf         , Wwf         , Rp          , Rb          , Chw         , Rb^Uf       , Rp          , Mm          , Wwf         , Wwf         , Rb          , Hh          , Rb          , Rb          , Rb          , Rb          , Hh          , Gs^Fds      , Mm          , Hh          , Hh          , Gs^Ft       , Wwf         , Gs^Ft       , _off^_usr   , _off^_usr   
_off^_usr   , _off^_usr   , Rb          , Chw         , Rb          , Wwf         , Rb          , Wwf         , Wwf         , Rb          , Wwf         , Rb          , Wwf         , Wwf         , Wwf         , Gs^Ft       , Wwf         , Mm^Xm       , Wwf         , Rp          , Rp          , Rb          , Rp          , Hh          , Mm^Xm       , Mm^Xm       , Chw         , Wwf         , Wwf         , Gs^Fds      , Wwf         , Rb          , Rb          , Rb          , Rb          , Chw         , Rb          , Rb          , Rb          , Wwf         , Wwf         , _off^_usr   , _off^_usr   
_off^_usr   , _off^_usr   , Rb          , Rb          , Rb          , Rb          , Gs^Ft       , Hh          , Rb          , Wwf         , Mm          , Wwf         , Rb          , Rb          , Rb          , Wwf         , Hh          , Wwf         , Mm^Xm       , Mm^Xm       , Hh          , Rp          , Mm^Xm       , Chw         , Kh          , Chw         , Rb          , Rb          , Rb          , Wwf         , Mm          , Wwf         , Wwf         , Rb          , Rb          , Rb          , Gs^Vht      , Rb          , Gs^Ft       , Mm          , Chw         , _off^_usr   , _off^_usr   
_off^_usr   , _off^_usr   , Hh          , Gs^Vht      , Rb          , Mm          , Hh          , Gs^Fds      , Rb          , Hh          , Rb          , Rb          , Rb          , Gs^Ft       , Hh^Vhh      , Wwf         , Wwf         , Mm          , Mm          , Mm^Xm       , Ss^Vhs      , Mm^Xm       , Wwf         , Mm          , Chw         , Rb          , Rb          , Hh          , Hh          , Rb          , Chw         , Hh          , Wwf         , Wwf         , Wwf         , Wwf         , Wwf         , Gs^Fds      , Wwf         , Wwf         , Wwf         , _off^_usr   , _off^_usr   
_off^_usr   , _off^_usr   , _off^_usr   , Gs^Fds      , Rb          , Hh          , Rb          , Rb          , Kh          , Rb          , Chr         , Rb          , Kh          , Hh          , Rb          , Rb          , Rb          , Wwf         , Wwf         , Hh          , Wwf         , Wwf         , Rb          , Wwf         , Chr         , Rb          , Rb          , Mm          , Wwf         , Wwf         , Rb          , Ss^Vhs      , Rb          , Rb          , Rb          , Rb          , Rb          , Wwf         , Rb          , Rb          , _off^_usr   , _off^_usr   , _off^_usr   
_off^_usr   , _off^_usr   , _off^_usr   , _off^_usr   , _off^_usr   , Rb          , Gs^Ft       , Rb          , Rb          , Chr         , Rb          , Chr         , Chr         , Rb^Uf       , Rb          , Rb          , Chw         , Rb          , Rb          , Wwf         , Mm          , Wwf         , Rb          , Rb          , Rb          , Rb          , Rb          , Gs^Ft       , Wwf         , Rb          , Rb          , Rb          , Rb          , Rb          , Chw         , Hh^Uf       , Hh          , Rb          , _off^_usr   , _off^_usr   , _off^_usr   , _off^_usr   , _off^_usr   
_off^_usr   , _off^_usr   , _off^_usr   , _off^_usr   , _off^_usr   , _off^_usr   , _off^_usr   , Ss^Vhs      , Gs^Ft       , Rb          , Rb          , Rb          , Rb          , Chw         , Wwf         , Rb          , Rb          , Chw         , Rb          , Wwf         , Wwf         , Wwf         , Rb          , Gs^Ft       , Gs^Ft       , Mm^Vhh      , Wwf         , Wwf         , Rb          , Rb          , Rb          , Gs^Ft       , Mm          , Rb          , Gs^Ft       , Chr         , _off^_usr   , _off^_usr   , _off^_usr   , _off^_usr   , _off^_usr   , _off^_usr   , _off^_usr   
_off^_usr   , _off^_usr   , _off^_usr   , _off^_usr   , _off^_usr   , _off^_usr   , _off^_usr   , _off^_usr   , _off^_usr   , Mm          , Wwf         , Chw         , Wwf         , Wwf         , Wwf         , Rb          , Wwf         , Rb          , Rb          , Rb          , Wwf         , Rb          , Rb          , Hh          , Rb          , Rb          , Wwf         , Rb          , Rb          , Rb          , Rb          , Hh          , Gs^Fds      , Mm          , _off^_usr   , _off^_usr   , _off^_usr   , _off^_usr   , _off^_usr   , _off^_usr   , _off^_usr   , _off^_usr   , _off^_usr   
_off^_usr   , _off^_usr   , _off^_usr   , _off^_usr   , _off^_usr   , _off^_usr   , _off^_usr   , _off^_usr   , _off^_usr   , _off^_usr   , _off^_usr   , Wwf         , Ss^Vhs      , Rb          , Rb          , Wwf         , Rb          , Wwf         , Wwf         , Wwf         , Chw         , Rb          , Rb          , Rb          , Chw         , Wwf         , Rb          , Rb          , Rb          , Gs^Ft       , Gs^Ft       , Rb^Uf       , _off^_usr   , _off^_usr   , _off^_usr   , _off^_usr   , _off^_usr   , _off^_usr   , _off^_usr   , _off^_usr   , _off^_usr   , _off^_usr   , _off^_usr   
_off^_usr   , _off^_usr   , _off^_usr   , _off^_usr   , _off^_usr   , _off^_usr   , _off^_usr   , _off^_usr   , _off^_usr   , _off^_usr   , _off^_usr   , _off^_usr   , _off^_usr   , Rb          , Rb^Uf       , Rb          , Gs^Ft       , Rb          , Chr         , 2 Kh        , Chr         , Wwf         , Chw         , Wwf         , Chr         , 3 Kh        , Chr         , Rb          , Ss          , Ss^Vhs      , _off^_usr   , _off^_usr   , _off^_usr   , _off^_usr   , _off^_usr   , _off^_usr   , _off^_usr   , _off^_usr   , _off^_usr   , _off^_usr   , _off^_usr   , _off^_usr   , _off^_usr   
_off^_usr   , _off^_usr   , _off^_usr   , _off^_usr   , _off^_usr   , _off^_usr   , _off^_usr   , _off^_usr   , _off^_usr   , _off^_usr   , _off^_usr   , _off^_usr   , _off^_usr   , _off^_usr   , _off^_usr   , Gs^Ft       , Ss^Vhs      , Rb          , Rb          , Chr         , Rb          , Chw         , Chw         , Chw         , Rb          , Chr         , Rb          , Rb          , _off^_usr   , _off^_usr   , _off^_usr   , _off^_usr   , _off^_usr   , _off^_usr   , _off^_usr   , _off^_usr   , _off^_usr   , _off^_usr   , _off^_usr   , _off^_usr   , _off^_usr   , _off^_usr   , _off^_usr   
_off^_usr   , _off^_usr   , _off^_usr   , _off^_usr   , _off^_usr   , _off^_usr   , _off^_usr   , _off^_usr   , _off^_usr   , _off^_usr   , _off^_usr   , _off^_usr   , _off^_usr   , _off^_usr   , _off^_usr   , _off^_usr   , _off^_usr   , Ss          , Chs         , Rb          , Rb          , Wwf         , Wwf         , Wwf         , Gs^Vht      , Rb          , _off^_usr   , _off^_usr   , _off^_usr   , _off^_usr   , _off^_usr   , _off^_usr   , _off^_usr   , _off^_usr   , _off^_usr   , _off^_usr   , _off^_usr   , _off^_usr   , _off^_usr   , _off^_usr   , _off^_usr   , _off^_usr   , _off^_usr   
_off^_usr   , _off^_usr   , _off^_usr   , _off^_usr   , _off^_usr   , _off^_usr   , _off^_usr   , _off^_usr   , _off^_usr   , _off^_usr   , _off^_usr   , _off^_usr   , _off^_usr   , _off^_usr   , _off^_usr   , _off^_usr   , _off^_usr   , _off^_usr   , _off^_usr   , Mm          , _off^_usr   , Wwf         , _off^_usr   , Gs^Ft       , _off^_usr   , _off^_usr   , _off^_usr   , _off^_usr   , _off^_usr   , _off^_usr   , _off^_usr   , _off^_usr   , _off^_usr   , _off^_usr   , _off^_usr   , _off^_usr   , _off^_usr   , _off^_usr   , _off^_usr   , _off^_usr   , _off^_usr   , _off^_usr   , _off^_usr   
_off^_usr   , _off^_usr   , _off^_usr   , _off^_usr   , _off^_usr   , _off^_usr   , _off^_usr   , _off^_usr   , _off^_usr   , _off^_usr   , _off^_usr   , _off^_usr   , _off^_usr   , _off^_usr   , _off^_usr   , _off^_usr   , _off^_usr   , _off^_usr   , _off^_usr   , _off^_usr   , _off^_usr   , _off^_usr   , _off^_usr   , _off^_usr   , _off^_usr   , _off^_usr   , _off^_usr   , _off^_usr   , _off^_usr   , _off^_usr   , _off^_usr   , _off^_usr   , _off^_usr   , _off^_usr   , _off^_usr   , _off^_usr   , _off^_usr   , _off^_usr   , _off^_usr   , _off^_usr   , _off^_usr   , _off^_usr   , _off^_usr   
