border_size=1
usage=map

Ha          , Aa          , Ha          , Ms          , Ss          , Ss          , Gs          , Gg          , Ha          , Gg          , Ms          , Cea         , Cea         , Aa^Fma      , Gs          , Ms          , Ss          , Ha          , Hh          , Ha          , Chw         , Aa          , Ai          , Aa          , Aa          , Aa          , Ww          , Ww          , Ai          
Ha          , Aa^Fpa      , Hh          , Mm          , Gs^Fp       , Mm          , Gs          , Gg          , Hh          , Gs^Fms      , Mm          , Rb          , Rb          , Gs^Fp       , Gs^Efm      , Mm          , Ss          , Hh          , Wwf         , Gg^Fet      , Chw         , Ww          , Ww          , Ww          , Aa          , Ai          , Ai          , Ai          , Ai          
Gs          , Gs          , Gs          , Gs          , Gg^Vc       , Gs          , Gg          , Gs^Fds      , Gg^Fet      , Gg^Efm      , Hh          , Mm          , Gs          , Rb          , Ww^Bw\      , Wwf         , Gs^Fp       , Wwf         , Hh          , Ss          , Wwf         , Chw         , Hh          , Aa^Fpa      , Ds          , Ww          , Ww          , Ww          , Ai          
Ms          , Ha          , Gg          , Gs          , Gs          , Gg          , Gg          , Gg          , Gs          , Ss^Vhs      , Gs          , Gg          , Gg          , Wwf         , Wwf         , Rb          , Ww^Bw\      , Wwf         , Mm          , Hh          , Gll         , Wwf         , Wwf         , Wwf         , Wwf         , Gg^Fet      , Ww          , Ai          , Ww          
Aa          , Gg^Fet      , Gg          , Gs          , Gs^Fms      , Gg          , Gs          , Gs          , Gs          , Gd          , Gg          , Gg          , Gs          , Wwf         , Gg^Efm      , Gs^Fp       , Wwf         , Rb          , Rb          , Gs^Fp       , Gs          , Ss^Vhs      , Gs^Fp       , Gg          , Gg^Efm      , Wwf         , Wwf         , Ww          , Ww          
Gg          , Gg          , Gd          , Gg          , Mm          , Hh          , Gd          , Gd          , Gs^Fms      , Mm          , Gs^Fds      , Gs^Fds      , Gd          , Hh          , Gs^Fp       , Hh          , Hh          , Gs^Fds      , Gs          , Rb          , Rb          , Rb          , Mm          , Hh          , Gs          , Wwf         , Wwf         , Aa^Vhha     , Aa          
Ha          , Gg          , Gg          , Gs^Fp       , Gg          , Gs^Fp       , Gg^Vc       , Gd          , Gll         , Hh          , Gs^Fms      , Mm          , Hh          , Gs^Fms      , Gs          , Mm          , Gd          , Gs          , Gs          , Gg          , Gg          , Gs          , Gg          , Gg          , Gg^Vc       , Gs          , Aa          , Ai          , Ai          
Ms          , Mm          , Cha         , Gg          , Gs          , Gd          , Gd          , Gll         , Gd          , Gll         , Gll         , Hh          , Gs^Fp       , Ss          , Ss          , Gs          , Gg          , Gd          , Gs^Fds      , Mm          , Gs^Fds      , Gs          , Gs          , Gg          , Gs          , Gg          , Cha         , Gs^Fp       , Ai          
Ha          , Hhd^Emf     , Cha         , Gs          , Gd          , Gs          , Gg          , Gs          , Gg          , Gs^Fp       , Hh          , Gs          , Gs          , Ss          , Gs^Fp       , Hh          , Gs          , Gs^Fds      , Hh          , Hh          , Re^Vct      , Gs^Fp       , Gs          , Gs          , Gs          , Gs          , Cha         , Hh^Emf      , Aa^Fda      
Ha          , Ms          , Rb          , 1 Kha       , Gs          , Mm          , Hh          , Gs          , Gs          , Gg^Vct      , Gs          , Gd          , Gg^Vc       , Gs          , Mm          , Hh          , Gd          , Gg^Vc       , Gs          , Gs          , Gs          , Gs          , Hh          , Gg          , Gd          , 4 Kha       , Hh          , Ms          , Ms          
Ha          , Ha          , Rb          , Cha         , Cha         , Gs^Fp       , Gg          , Gs          , Gs          , Gd          , Gll         , Gd          , Hh          , Gg^Efm      , Hh          , Gs^Fds      , Gg          , Gll         , Gd          , Mm          , Gs^Fms      , Hh          , Gs^Fp       , Gs          , Cha         , Cha         , Rb          , Ha^Fpa      , Aa^Fda      
Aa          , Aa^Fpa      , Aa          , Rb          , Cha         , Gd          , Gd          , Gs          , Gg          , Gs          , Gg          , Gd          , Gg          , Hh          , Gd          , Gs          , Gs^Fms      , Gs          , Hh          , Gs          , Gg          , Gg          , Gll         , Gd          , Cha         , Rb          , Aa          , Aa^Fpa      , Ha          
Aa          , Aa          , Ms          , Rb          , Kha         , Gs          , Gd          , Gg^Vct      , Gs^Fp       , Hh          , Gs^Fp       , Gll         , Gg          , Gs^Fds      , Gll^Gvs     , Gll^Gvs     , Gll^Gvs     , Hh          , Gs          , Gs^Fms      , Hh          , Gg^Vct      , Gd          , Gll         , Kha         , Rb          , Ms          , Ha          , Ha          
Ms          , Ms          , Rb          , Rb          , Rb          , Gll         , Gd          , Hh          , Hh          , Mm          , Gg^Efm      , Gd          , Gd          , Gs          , Gll^Gvs     , Rb^Wm       , Gll^Gvs     , Gs          , Gg          , Mm          , Hh          , Gs          , Gs          , Gd          , Rb          , Rb          , Rb          , Aa^Fpa      , Ha          
Ha          , Aa^Fpa      , Ms          , Rb          , Kha         , Gs          , Gs          , Gs          , Hh          , Gs^Fp       , Gg^Efm      , Gs          , Gs          , Gd          , Hh          , Gll^Gvs     , Gs          , Gd          , Hh          , Gs^Fp       , Hh          , Gg          , Gs^Fp       , Gd          , Kha         , Rb          , Ms          , Ha          , Ha          
Aa          , Ha          , Aa          , Rb          , Cha         , Gs          , Gd          , Gg          , Gg          , Hh          , Hh          , Gs^Fds      , Gs          , Gd          , Gs^Efm      , Mm          , Gs^Fds      , Gs          , Gs          , Gs          , Gs          , Gg          , Gs          , Gd          , Cha         , Rb          , Aa^Em       , Ha          , Ms          
Ha          , Aa^Fpa      , Rb          , Rb          , Cha         , Gll         , Hh          , Gg^Vct      , Gs^Fds      , Gs          , Gd          , Gg          , Gs          , Gs          , Hh          , Hh          , Hh          , Gs          , Gs          , Gll         , Gd          , Gs^Vct      , Gg          , Gs          , Cha         , Rb          , Rb          , Aa^Fpa      , Ha          
Ha          , Ha          , Rb          , Cha         , Gd          , Gd          , Mm          , Gs^Fds      , Gg          , Gs^Fds      , Gg          , Gll         , Gg^Vc       , Gll         , Gs^Fds      , Gg^Fet      , Gg^Efm      , Gs          , Gg^Vc       , Gd          , Gll         , Gll         , Hh          , Hh          , Gd          , Cha         , Rb          , Ha          , Ha          
Ha          , Rb          , Cha         , 3 Kha       , Gs          , Gg          , Gs          , Gd          , Gll         , Gs          , Hh          , Gd          , Gs          , Hh          , Gs          , Gs^Fds      , Gs          , Gs          , Gs^Fp       , Hh          , Gs          , Gll         , Gd          , Gs^Fp       , Gd          , 2 Kha       , Cha         , Ms          , Ha          
Ha          , Ms          , Cha         , Gd          , Gd          , Gd          , Gs          , Hh          , Gs^Fds      , Gs^Fds      , Hh          , Gs          , Gd          , Gg          , Ss          , Ss          , Mm          , Gs          , Gs          , Mm          , Gd          , Gll         , Gll         , Gs          , Gg          , Gd          , Cha         , Ha          , Ha          
Ms          , Hh^Emf      , Aa          , Gd          , Gg^Vct      , Gll         , Gs          , Gg^Efm      , Gs          , Mm          , Gs          , Gll         , Gs          , Gs          , Gs          , Ss          , Hh          , Hh          , Gg          , Gs          , Gd          , Gll         , Gs          , Gs^Vct      , Gs          , Gll         , Gd          , Gs^Fp       , Gs          
Aa          , Gs^Fp       , Wwf         , Gs          , Gs          , Gd          , Gs^Fds      , Gs          , Rb          , Gs          , Gs          , Gs^Fds      , Hh          , Gs^Fp       , Mm          , Gs^Fp       , Gs          , Gs^Fms      , Gg          , Hh          , Mm          , Gs          , Gg          , Gg          , Gs^Fds      , Mm          , Gd          , Gd          , Aa          
Ai          , Aa^Vhha     , Wwf         , Wwf         , Gg          , Hh          , Gs^Fds      , Rb          , Gs          , Rb          , Rb          , Gs^Vc       , Wwf         , Hh          , Gs^Fp       , Hh          , Gg          , Hh          , Gg          , Hh          , Gg^Fet      , Gg          , Gs^Fms      , Hh          , Hh          , Gg^Efm      , Gg^Vc       , Gg          , Aa          
Ww          , Ai          , Ww          , Wwf         , Wwf         , Gg^Efm      , Ss^Vhs      , Rb          , Gd          , Mm          , Gg^Fet      , Rb          , Ww^Bw\      , Gs^Fds      , Wwf         , Wwf         , Gs          , Gs          , Ss^Vhs      , Gg          , Gg          , Gg          , Gs          , Gg^Efm      , Gs^Fds      , Gs          , Gs          , Gg          , Gg          
Ww          , Ww          , Ww          , Gg^Fet      , Ds          , Wwf         , Wwf         , Gg          , Gg^Efm      , Gs          , Hh          , Wwf         , Hh          , Rb          , Ww^Bw\      , Wwf         , Gs          , Gll         , Gs^Fms      , Hh          , Gg          , Gd          , Gll         , Gs          , Gs          , Gll         , Gs          , Aa^Fpa      , Gg          
Ai          , Ai          , Ai          , Ww          , Aa^Fpa      , Hh          , Chw         , Wwf         , Ss          , Gg          , Wwf         , Wwf         , Wwf         , Wwf         , Gg          , Rb          , Rb          , Gs          , Gll         , Hh          , Gs          , Gs          , Gs          , Hh          , Gg^Vc       , Gs          , Gg          , Gg          , Aa          
Ww          , Ww          , Aa          , Aa          , Ww          , Ww          , Ww          , Chw         , Gs^Fp       , Wwf         , Hh          , Ss          , Gg          , Gg^Efm      , Mm          , Gs^Fds      , Hh          , Rb          , Rb          , Gs^Fds      , Hh          , Gg          , Gll         , Gs          , Gs^Fds      , Gs          , Ms          , Ms          , Aa          
Ww          , Ai          , Ai          , Ww          , Ww          , Ai          , Aa^Fma      , Chw         , Ha          , Ha          , Aa^Fma      , Gs^Fp       , Ss          , Ss          , Ms          , Ha          , Ha          , Cea         , Cea         , Ms          , Ha          , Gd          , Ha^Fpa      , Mm          , Ms          , Gg          , Ms          , Ha          , Hh          
