border_size=1
usage=map

Gs^Fms      , Hh          , Mm          , Gs^Fp       , Wwf         , Mm          , Mm          , Hh          , Hh^Fds      , Hh          , Hh          , Wwf         , Hh          , Mm          , Hh^Fds      , Mm          , Wwf         , Wwf         , Hh          , Mm          , Mm          , Mm          , Mm          
Wwf         , Wwf         , Hh          , Gs^Fp       , Wwf         , Mm          , Mm          , Hh          , Gg^Efm      , Mm          , Gg          , Wwf         , Gg          , Mm          , Hh          , Mm          , Wwf         , Wwf         , Hh          , Mm          , Mm          , Mm          , Mm          
Gs^Fms      , Wwf         , Wwf         , Wwf         , Gg^Vh       , Gg          , Wwf         , Mm          , Gg          , Gg          , Wwf         , Wwf         , Wwf         , Hh^Fds      , Wwf         , Wwf         , Gg          , Gg^Efm      , Mm          , Mm          , Wwf         , Mm          , Mm          
Mm          , Hh          , Wwf         , Gg^Fms      , Wwf         , Wwf         , Gg          , Gg          , Wwf         , Wwf         , Wwf         , 1 Kh        , Wwf         , Wwf         , Gg^Vc       , Gg          , Gg          , Gg          , Wwf         , Wwf         , Gs^Fms      , Wwf         , Wwf         
Wwf         , Wwf         , Mm          , Wwf         , Gs^Fp       , Wwf         , Wwf         , Wwf         , Gg          , Wwf         , Ch          , Ch          , Ch          , Wwf         , Gg          , Gg          , Wwf         , Wwf         , Gs^Vh       , Gs^Fp       , Re^Gvs      , Hh          , Hh          
Hh          , Hh          , Wwf         , Gs^Fp       , Wwf         , Wwf         , Gg          , Gg^Vh       , Gg          , Ch          , Wwf         , Ch          , Wwf         , Ch          , Wwf         , Wwf         , Mm          , Gs^Fp       , Gg          , Re^Gvs      , Gg^Wm       , Re^Gvs      , Re^Gvs      
Wwf         , Wwf         , Gs^Fms      , Wwf         , Hh          , Gs^Fp       , Re^Gvs      , Re^Gvs      , Gg          , Gg          , Wwf         , 4 Kh        , Gg          , Wwf         , Hh          , Gg          , Gg          , Gg          , Gg          , Gg          , Gg          , Hh          , Hh          
Hh          , Hh          , Gg^Vc       , Gg          , Re^Gvs      , Re^Gvs      , Gg          , Gg          , Wwf         , Wwf         , Gs^Fp       , Wwf         , Gs^Fp       , Mm          , Gg          , Gg          , Rb          , Rb          , Gg          , Gg          , Gg^Vc       , Gs^Fp       , Gs^Fms      
Gs^Fp       , Gs^Fp       , Gg          , Gg          , Gg          , Gg          , Wwf         , Wwf         , Mm          , Hh          , Gg          , Wwf         , Gg          , Gg          , Rb          , Rb          , Rb          , Gg          , Gs^Fp       , Gs^Fp       , Gg^Efm      , Hh          , Hh          
Hh          , Hh          , Mm          , Gg          , Wwf         , Wwf         , Gg          , Gg          , Rb          , Gg          , Wwf         , Wwf         , Gg          , Rb          , Gg          , Gg          , Rb          , Gg^Vh       , Hh          , Gg          , Rb          , Rb^Uf       , Rb          
Wwf         , Wwf         , Wwf         , Wwf         , Gs^Fp       , Gs^Vc       , Gg          , Rb          , Gg          , Ss^Vhs      , Hh          , Ww          , Gs^Fms      , Gg          , Hh          , Mm          , Wwf         , Wwf         , Wwf         , Gg          , Wwf         , Wwf         , Wwf         
Hh          , Hh          , Gs^Fms      , Gg          , Gg          , Hh          , Rb          , Rb          , Gg          , Ss          , Gs^Fp       , Ww          , Gg^Fp       , Ss^Vhs      , Wwf         , Wwf         , Gg          , Gg          , Gs^Fp       , Wwf         , Gs^Fms      , Gs^Fp       , Gs^Fp       
Gs^Fp       , Gs^Fp       , Gg          , Gg          , Rb^Uf       , Gg          , Rb          , Gg          , Hh          , Mm          , Wwf         , Ww          , Wwf         , Gg          , Wwf         , Gg          , Hh          , Rb^Uf       , Rb          , Gs          , Gs          , Hh          , Hh          
Gs          , Gs          , Gg          , Hh          , Rb          , Rb          , Gs^Fp       , Gg          , Gg          , Wwf         , Gg          , Gg          , Gg          , Wwf         , Gg          , Gg          , Gs^Fms      , Rb          , Rb          , Mm          , Gg          , Gg^Efm      , Gg          
Gg          , Gg          , Gs          , Mm          , Rb          , Rb          , Hh          , Gg          , Wwf         , Wwf         , Wwf         , Gg          , Wwf         , Wwf         , Hh          , Gg          , Rb          , Rb          , Rb^Uf       , Hh          , Gg          , Gg          , Gg          
Hh          , Hh          , Gs^Fp       , Gs          , Gs^Fp       , Rb^Uf       , Gg          , Gg          , Wwf         , Gg          , Gg^Fp       , Ww          , Gs^Fp       , Mm          , Gg          , Gg          , Rb          , Gg          , Gg          , Gg          , Gs^Fp       , Gs^Fms      , Gs^Fp       
Gs^Fp       , Gs^Fms      , Wwf         , Wwf         , Wwf         , Gg          , Wwf         , Wwf         , Hh          , Ss^Vhs      , Gs^Fp       , Ww          , Hh          , Ss          , Gg          , Rb          , Gg          , Hh          , Gs^Fms      , Gg^Wm       , Wwf         , Hh          , Hh          
Wwf         , Wwf         , Rb          , Rb          , Hh          , Wwf         , Rb          , Mm          , Gg          , Gg          , Gg          , Ww          , Wwf         , Ss^Vhs      , Rb          , Rb          , Gg          , Gg^Vc       , Wwf         , Wwf         , Mm          , Wwf         , Wwf         
Rb          , Rb^Uf       , Gg^Efm      , Gg          , Gs^Fp       , Gs^Vh       , Rb          , Gg          , Rb          , Rb          , Gg          , Wwf         , Gg          , Gg          , Mm          , Gg          , Wwf         , Wwf         , Gg          , Gg          , Gg^Efm      , Hh          , Hh          
Hh          , Hh          , Gg^Vc       , Gs^Fms      , Gg          , Gg          , Rb          , Rb          , Gg          , Gg          , Gs^Fp       , Wwf         , Gs^Fp       , Hh          , Wwf         , Wwf         , Gg          , Gg          , Re^Gvs      , Gg          , Gg^Vc       , Gs^Fms      , Gs^Fds      
Gs^Fp       , Gs^Fms      , Gg          , Gg          , Gg          , Rb          , Gg          , Gg          , Hh          , Mm          , Gg          , Wwf         , Wwf         , Wwf         , Gg          , Gg          , Re^Gvs      , Re^Gvs      , Hh          , Gg          , Gs^Fms      , Wwf         , Wwf         
Hh          , Hh          , Gs^Wm       , Gg          , Gs          , Gg          , Mm          , Gg          , Wwf         , Wwf         , Wwf         , 3 Kh        , Wwf         , Gg          , Gg          , Re^Gvs      , Gg          , Gs^Fp       , Wwf         , Wwf         , Wwf         , Hh          , Hh          
Re^Gvs      , Re^Gvs      , Re^Gvs      , Re^Gvs      , Gg^Vh       , Gs^Fp       , Wwf         , Wwf         , Gg          , Ch          , Ch          , Ch          , Ch          , Ch          , Gg          , Gg^Vh       , Wwf         , Wwf         , Gg^Vh       , Gg^Fp       , Wwf         , Wwf         , Wwf         
Hh          , Hh          , Gs^Fms      , Gs^Fp       , Wwf         , Wwf         , Gg          , Gg          , Gg^Vc       , Wwf         , Wwf         , Ch          , Wwf         , Wwf         , Wwf         , Wwf         , Gg          , Wwf         , Wwf         , Wwf         , Hh          , Mm          , Hh^Fds      
Gs^Fms      , Gs^Fp       , Wwf         , Wwf         , Mm          , Gg          , Hh          , Gg          , Gs          , Gg          , Wwf         , 2 Kh        , Wwf         , Wwf         , Gg          , Gg          , Wwf         , Wwf         , Gs^Fp       , Wwf         , Gg^Efm      , Hh          , Gs^Fms      
Gs^Fp       , Gs^Fp       , Wwf         , Wwf         , Hh          , Hh          , Mm          , Mm          , Gg^Fp       , Gs          , Gg          , Wwf         , Gg          , Gg          , Gg^Fp       , Gs^Fds      , Wwf         , Hh          , Gs          , Hh          , Gg          , Gs^Fds      , Gs^Fms      
