border_size=1
usage=map

Mm^Xm       , Mm^Xm       , Mm^Xm       , Mm^Xm       , Hh^Ft       , Cv          , Cv          , Cv          , Wo          , Wo          , Wo          , Wo          , Wo          , Ww          , Ss          , Ss^Ft       , Gs^Ft       , Hh          , Hh^Ft       , Hh          , Hh          , Hh          , Hh          , Mm^Xm       , Mm^Xm       , Mm^Xm       , Mm^Xm       
Mm^Xm       , Mm^Xm       , Mm^Xm       , Mm^Xm       , Hh^Ft       , Hh          , Cv          , Ww          , Ww          , Wo          , Wo          , Wo          , Wo          , Ww          , Ss          , Ss^Ft       , Gs^Ft       , Hh          , Hh          , Hh          , Hh          , Hh          , Hh^Vc       , Mm^Xm       , Mm^Xm       , Mm^Xm       , Mm^Xm       
Mm^Xm       , Mm^Xm       , Mm^Xm       , Hh          , Hh          , 4 Kv        , Cv          , Cv          , Ww          , Wo          , Wo          , Wo          , Ww          , Ww          , Ss          , Ss^Vhs      , Hh          , Gs^Ft       , Gs^Es       , Hh          , Gs^Es       , Gs^Ft       , Rp          , Hh^Emf      , Mm          , Mm^Xm       , Mm^Xm       
Rp          , Rp          , Rp          , Rr^Vd       , Rp          , Cv          , Rp          , Cv          , Rp          , Ww          , Ww          , Ww          , Gs^Es       , Ss          , Gs          , Gs          , Chs         , Gs^Ft       , Gs          , Gs          , Gs^Gvs      , Gs          , Rp          , Gs^Ft       , Gs^Ft       , Hh          , Hh          
Mm^Xm       , Mm^Xm       , Gg^Fet      , Rp          , Rp          , Rp          , Rp          , Rp          , Rr^Vd       , Ww^Bw\      , Ww^Bw\      , Ww          , Gs          , Gs^Es       , Gs          , Hh          , Gs          , Gs          , Ss^Vhs      , Gs^Gvs      , Gs^Ft       , Gs^Gvs      , Rp          , Hh          , Hh          , Rr^Vd       , Rp          
Mm^Xm       , Mm^Xm       , Mm^Xm       , Gs^Ft       , Rp          , Rp          , Rp          , Gs^Ft       , Hh          , Ww          , Ww          , Rp          , Rp          , Gs          , Gs          , Gs          , Gs          , Ss^Ft       , Hh          , Ss^Ft       , Mm          , Gs^Gvs      , Rp          , Gs^Efm      , Rp          , Rp          , Hh          
Mm^Xm       , Mm^Xm       , Gs^Ft       , Rp          , Gs^Ft       , Rp          , Rp          , Gs          , Gs^Efm      , Wo          , Ww          , Ss          , Ss^Vhs      , Rp          , Rp          , Gs          , Gs^Ft       , Hh^Emf      , Mm          , Mm          , Mm          , Gs^Gvs      , Rp          , Rp          , Gs^Ft       , Hh          , Gs          
Mm          , Hh^Emf      , Rp          , Rr^Vd       , Hh          , Gs^Ft       , Rp          , Gs          , Ww          , Wo          , Ww          , Ss          , Ss^Ft       , Hh          , Hh          , Rp          , Rp          , Hh          , Gs^Ft       , Mm          , Gs^Gvs      , Gs^Gvs      , Rp          , Gs^Ft       , Gs^Gvs      , Gs^Gvs      , Gs^Gvs      
Cv          , 1 Kv        , Cv          , Rp          , Rp          , Rp          , Gs          , Rp          , Ww^Bw\      , Ww          , Gs          , Gs          , Gs^Ft       , Gs^Ft       , Mm          , Gs          , Rp          , Rr^Vd       , Gs^Gvs      , Gs^Gvs      , Rp          , Rp          , Hh^Emf      , Rp          , Rp          , Gs          , Gs^Gvs      
Cv          , Cv          , Cv          , Cv          , Rp          , Gs          , Ww          , Ww          , Ww          , Rp          , Rp          , Gs          , Rp          , Hh^Emf      , Rp          , Rp          , Gs^Ft       , Rp          , Rp          , Rp          , Gs^Ft       , Mm          , Hh          , Rr^Vd       , Rp          , Gs^Efm      , Gs^Efm      
Cv          , Cv          , Rp          , Rp          , Ds          , Ds          , Ww          , Wo          , Ww          , Wwf         , Chw         , Rp          , Wwf         , Rp          , Ss^Vhs      , Gs^Gvs      , Gs          , Hh          , Gs          , Gs          , Gs          , Gs^Ft       , Gs^Ft       , Gs^Ft       , Rp          , Gs          , Gs^Efm      
Rp          , Rp          , Rp          , Gs          , Ds          , Ww          , Ww^Vm       , Wo          , Ww          , Gs^Ft       , Gs          , Wwf         , Ss          , Ss^Ft       , Hh          , Hh          , Gs          , Gs          , Wwf         , Ds          , Ds          , Hh          , Gs^Ft       , Mm          , Rp          , Gs          , Gs^Efm      
Gs          , Rr^Vd       , Rp          , Gs          , Gs          , Ww          , Ww          , Ww          , Hh          , Gs^Ft       , Gs^Gvs      , Ss          , Wwr         , Wwr         , Ww          , Mm          , Ww          , Wwf         , Gs^Gvs      , Wwf         , Wwf         , Gs          , Gs          , Gs^Ft       , Rp          , Gs^Gvs      , Gs^Gvs      
Gs^Ft       , Rp          , Rp          , Hh          , Gs          , Wo          , Ww          , Mm          , Hh          , Gg^Vc       , Gs^Gvs      , Ww          , Wo          , Wo          , Wo          , Ww          , Gs^Gvs      , Gs^Gvs      , Hh          , Ds          , Ww          , Ww          , Gs          , Hh          , Rp          , Gs^Ft       , Gs^Ft       
Gs^Gvs      , Gs^Ft       , Rp          , Hh          , Gs          , Ww          , Wwf         , Ds          , Gs^Gvs      , Gs^Gvs      , Ww          , Ww          , Ww          , Wo          , Wwr         , Ww          , Gs^Gvs      , Gg^Vc       , Hh          , Mm          , Ww          , Wo          , Gs          , Hh          , Rp          , Rp          , Gs          
Gs          , Gs^Gvs      , Rp          , Gs^Ft       , Gs^Ft       , Gs          , Ds          , Wwf         , Wwf         , Wwf         , Gs          , Mm          , Hh          , Wwr         , Ss          , Ss          , Gs          , Gs^Ft       , Ww          , Ww          , Ww^Vm       , Ww          , Ds          , Gs          , Rp          , Rr^Vd       , Rp          
Gs^Efm      , Gs          , Rp          , Mm          , Gs^Ft       , Hh          , Gs          , Ds          , Gs          , Gs          , Gs          , Hh          , Ss^Vhs      , Ss^Ft       , Wwf         , Wwf         , Chw         , Gs^Ft       , Ww          , Wo          , Ww          , Ww          , Ds          , Gs          , Rp          , Rp          , Rp          
Gs^Efm      , Gs          , Rp          , Gs^Ft       , Hh          , Gs^Ft       , Gs^Ft       , Gs          , Rp          , Hh          , Gs^Ft       , Gs          , Rp          , Rp          , Rp          , Rp          , Rp          , Wwf         , Ww          , Wo          , Ww          , Ds          , Rp          , Rp          , Cv          , Cv          , Cv          
Gs^Gvs      , Gs^Efm      , Rp          , Rr^Vd       , Hh^Emf      , Mm          , Rp          , Rp          , Gs^Gvs      , Rp          , Rp          , Rp          , Mm          , Hh^Emf      , Gs^Ft       , Gs          , Gs          , Rp          , Ww^Bw\      , Ww          , Gs          , Gs          , Rp          , Cv          , Cv          , Cv          , Cv          
Gs^Gvs      , Gs          , Gs^Gvs      , Rp          , Rp          , Rp          , Gs^Gvs      , Gs^Gvs      , Gs^Ft       , Rr^Vd       , Rp          , Gs          , Hh          , Gs^Ft       , Ss^Ft       , Gs          , Ww          , Ww          , Ww          , Rp          , Rp          , Rp          , Hh          , Rp          , Rp          , 2 Kv        , Cv          
Gs^Gvs      , Gs^Gvs      , Gs^Ft       , Gs^Ft       , Rp          , Gs^Gvs      , Mm          , Mm          , Mm          , Hh          , Gs^Ft       , Rp          , Rp          , Hh          , Ss^Vhs      , Ss          , Ww          , Wo          , Gs^Efm      , Gs          , Rp          , Gs^Ft       , Gs^Ft       , Rr^Vd       , Gs^Ft       , Hh^Emf      , Mm          
Hh          , Hh          , Rp          , Rp          , Rp          , Gs^Gvs      , Mm          , Mm          , Hh          , Hh^Emf      , Gs          , Gs          , Gs          , Rp          , Rp          , Ss          , Ww          , Wo          , Hh          , Gs          , Rp          , Rp          , Rp          , Rp          , Mm^Xm       , Mm^Xm       , Mm^Xm       
Rp          , Rp          , Hh          , Gs^Efm      , Rp          , Gs^Gvs      , Gs^Ft       , Ss^Ft       , Ss^Vhs      , Ss^Ft       , Gs          , Gs          , Gs          , Gs          , Gs          , Rp          , Ww^Bw\      , Ww          , Rr^Vd       , Gs^Ft       , Rp          , Rp          , Rp          , Gs^Ft       , Gg^Fet      , Mm^Xm       , Mm^Xm       
Rp          , Rr^Vd       , Gs^Ft       , Hh          , Rp          , Gs^Gvs      , Gs^Gvs      , Gs^Gvs      , Gs          , Gs          , Chs         , Hh          , Gs          , Gs^Es       , Gs^Es       , Ww          , Ww          , Ww^Bw\      , Rp          , Rp          , Rp          , Rp          , Rp          , Rp          , Rp          , Mm^Xm       , Mm^Xm       
Hh          , Hh          , Mm          , Gs^Ft       , Rp          , Gs          , Gs^Es       , Gs          , Gs^Es       , Gs^Ft       , Hh          , Gs          , Ss          , Ss          , Ww          , Ww          , Wo          , Ww          , Ww          , Cv          , Cv          , Cv          , Hh          , Rr^Vd       , Mm^Xm       , Rp          , Rp          
Mm^Xm       , Mm^Xm       , Mm^Xm       , Hh^Emf      , Hh^Vc       , Gs^Ft       , Hh          , Hh          , Hh          , Gs^Ft       , Ss^Ft       , Ss^Vhs      , Ss          , Ww          , Wo          , Wo          , Wo          , Wo          , Wo          , Cv          , Cv          , 3 Kv        , Hh^Ft       , Hh          , Mm^Xm       , Mm^Xm       , Mm^Xm       
Mm^Xm       , Mm^Xm       , Mm^Xm       , Hh          , Hh          , Gs^Ft       , Hh          , Hh^Ft       , Hh          , Gs^Ft       , Ss^Ft       , Ss          , Ww          , Ww          , Wo          , Wo          , Wo          , Wo          , Wo          , Cv          , Cv          , Cv          , Hh          , Hh^Ft       , Mm^Xm       , Mm^Xm       , Mm^Xm       
