border_size=1
usage=map

Wo          , Wo          , Ww          , Ww          , Ww          , Wo          , Wo          , Wo          , Wo          , Wo          , Wo          , Wo          , Ww          , Wo          , Wo          , Wo          , Wo          , Wo          , Wo          , Ww          , Ww          , Ww          , Ww          , Wo          , Wo          , Wo          , Ww          , Wo          , Wo          , Wo          
Wo          , Ww          , Gs          , Gs          , Gs          , Ww          , Ww          , Wo          , Wo          , Wo          , Wo          , Wo          , Ww          , Ww          , Ww          , Wo          , Ww          , Wo          , Ww          , Ww          , Gs          , Gs          , Ww          , Wo          , Wo          , Wo          , Ww          , Wo          , Wo          , Wo          
Wo          , Ww          , Ww^Vm       , Ds          , Ww          , Ww          , Ww          , Wo          , Wo          , Wo          , Wo          , Ww          , Ww          , Ww          , Ww          , Ww          , Ww          , Ww          , Ww          , Gs^Ft       , Gs          , Ds          , Ww          , Ww          , Ww          , Ww^Vm       , Hh          , Ww          , Wo          , Wo          
Wo          , Wo          , Ww          , Ww          , Wo          , Wo          , Ww          , Ww          , Ww          , Ww          , Ww          , Ww          , Ww          , Gs^Ft       , Ss          , Ss          , Gs^Uf       , Ww          , Ww          , Gs          , Ww          , Ww          , Ww          , Ww          , Gs^Ft       , Gs^Ft       , Mm          , Ww          , Ww          , Ww          
Ww          , Ww          , Ds          , Ww          , Wo          , Ww          , Gs^Ft       , Gs^Uf       , Ww          , Ww          , Ds          , Gs          , Ww          , Ss          , Ss          , Gs^Ft       , Hh          , Gs          , Ww          , Ww          , Ww          , Ww          , Hh          , Gs^Ft       , Gs          , Hh^Uf       , Hh          , Gs^Ft       , Ww          , Ww          
Ww          , Gs          , Hh^Uf       , Ww          , Ww          , Ww          , Gs          , Hh          , Ww          , Ww          , Gs          , Gs          , Ww          , Gs^Ft       , Ce          , Ce          , Ce          , Ds          , Ww          , Ww          , Ww          , Ww          , Gs          , Gs          , Ds          , Ds          , Ds          , Hh          , Ww          , Ww          
Ww          , Gs          , Gs^Ft       , Mm          , Ww          , Ww          , Ww          , Ww          , Ds          , Ww          , Ww          , Ww          , Ss          , Gs^Ft       , Ce          , 1 Ke        , Ce          , Ds          , Hh          , Ss          , Ss          , Ww          , Gs          , Ww          , Ww          , Ww^Vm       , Ds          , Gs          , Ww          , Ww          
Ww          , Ww          , Ww          , Gs          , Wwf         , Ww^Vm       , Gs^Ft       , Gs          , Wwf         , Wwf         , Hh          , Ss^Vhs      , Gs^Ft       , Gs          , Gs          , Ce          , Gs          , Hh          , Gs^Ft       , Ss^Vhs      , Gs^Ft       , Wwf         , Wwf         , Ww          , Ww          , Ww          , Gs          , Gs          , Ww          , Ww          
Wo          , Wo          , Ww          , Ww          , Wwf         , Hh          , Ww          , Ww          , Gs          , Ds          , Gs          , Gs          , Gs          , Gs          , Hh          , Ss          , Gs^Ft       , Gs          , Gs          , Gs          , Gs          , Gs          , Ds          , Ww          , Wwf         , Wwf         , Ww          , Ds          , Ww          , Ww          
Wo          , Wo          , Ww          , Ww          , Gs          , Wwf         , Gs          , Gs^Ft       , Hh          , Gs^Uf       , Gs^Ft       , Gs          , Gs^Ft       , Hh          , Ss          , Ss          , Ss          , Gs          , Gs^Ft       , Hh          , Gs          , Gs          , Gs          , Ds          , Gs          , Wwf         , Hh          , Ww          , Ww          , Ww          
Ww          , Ww          , Ww          , Gs          , Hh          , Gs          , Hh          , Gs^Ft       , Gs^Ft       , Gs^Vht      , Gs          , Gs          , Gs          , Ss^Vhs      , Ww          , Gs^Ft       , Ww          , Ss^Vhs      , Hh          , Gs^Ft       , Gs^Ft       , Gs^Vht      , Gs^Ft       , Gs          , Gs          , Gs^Ft       , Ss^Vhs      , Ss          , Ww          , Ww          
Ww          , Ww          , Ss          , Ss^Vhs      , Gs          , Gs          , Gs          , Gs          , Gs          , Gs          , Gs          , Ds          , Ww          , Ww          , Wo          , Wo          , Ww          , Ww          , Wwf         , Gs          , Gs          , Hh          , Gs^Ft       , Hh          , Gs          , Gs          , Ss          , Ww          , Ww          , Ww          
Ww          , Ww          , Hh          , Gs^Ft       , Gs          , Gs          , Gs^Ft       , Gs          , Hh          , Ds          , Wwf         , Wwf         , Gs          , Ww          , Ww          , Wo          , Ww          , Gs          , Gs          , Wwf         , Ww          , Gs^Uf       , Ss^Vhs      , Gs^Ft       , Gs          , Gs          , Gs          , Ww          , Ww          , Ww          
Ww          , Ww          , Gs^Ft       , Gs^Ft       , Ce          , Gs          , Gs^Ft       , Ss^Vhs      , Ss          , Ww          , Hh          , Gs          , Wwf         , Wwf         , Ww^Vm       , Ww          , Gs          , Wwf         , Ww          , Hh          , Ww          , Ss          , Ss          , Gs          , Gs          , Ww          , Gs          , Gs          , Ss          , Ww          
Ww          , Ss          , Ss          , Ce          , 4 Ke        , Ce          , Ss          , Ss          , Wo          , Wo          , Gs^Ft       , Ds          , Ww          , Gs          , Hh          , Gs^Ft       , Wo          , Ww          , Ww          , Ww^Vm       , Ww          , Wo          , Ss          , Gs          , Ce          , Ce          , Ce          , Gs^Uf       , Ss          , Ww          
Ww          , Ss          , Gs^Uf       , Ce          , Ce          , Ce          , Gs          , Ss          , Wo          , Ww          , Ww^Vm       , Ww          , Ww          , Wo          , Gs^Ft       , Hh          , Gs          , Ww          , Ds          , Gs^Ft       , Wo          , Wo          , Ss          , Ss          , Ce          , 2 Ke        , Ce          , Ss          , Ss          , Ww          
Ww          , Ss          , Gs          , Gs          , Ww          , Gs          , Gs          , Ss          , Ss          , Ww          , Hh          , Ww          , Wwf         , Gs          , Ww          , Ww^Vm       , Wwf         , Wwf         , Gs          , Hh          , Ww          , Ss          , Ss^Vhs      , Gs^Ft       , Gs          , Ce          , Gs^Ft       , Gs^Ft       , Ww          , Ww          
Ww          , Ww          , Ww          , Gs          , Gs          , Gs          , Gs^Ft       , Ss^Vhs      , Hh          , Ww          , Wwf         , Gs          , Gs          , Ww          , Wo          , Ww          , Ww          , Gs          , Wwf         , Wwf         , Ds          , Hh          , Gs          , Gs^Ft       , Gs          , Gs          , Gs^Ft       , Hh          , Ww          , Ww          
Wo          , Ww          , Ww          , Ss          , Gs          , Gs          , Hh          , Gs^Ft       , Gs^Uf       , Gs          , Gs          , Wwf         , Ww          , Ww          , Wo          , Wo          , Ww          , Ww          , Ds          , Gs          , Gs^Uf       , Gs          , Gs          , Gs          , Gs          , Gs          , Ss^Vhs      , Ss          , Ww          , Ww          
Ww          , Ww          , Ss          , Ss^Vhs      , Gs^Ft       , Gs          , Gs          , Gs^Ft       , Gs^Vht      , Gs^Ft       , Gs^Ft       , Hh          , Ss^Vhs      , Ww          , Gs^Ft       , Ww          , Ss^Vhs      , Gs          , Gs          , Gs          , Gs^Vht      , Gs^Ft       , Gs^Ft       , Hh          , Gs          , Hh          , Gs          , Ww          , Ww          , Ww          
Ww          , Ww          , Ww          , Hh          , Wwf         , Gs          , Ds          , Gs          , Gs          , Gs          , Hh          , Gs^Ft       , Gs          , Ss          , Ss          , Ss          , Hh          , Gs^Ft       , Gs          , Gs^Ft       , Gs          , Hh          , Gs^Ft       , Gs          , Wwf         , Gs          , Ww          , Ww          , Wo          , Wo          
Ww          , Ww          , Ds          , Ww          , Wwf         , Wwf         , Ww          , Ds          , Gs          , Gs          , Gs          , Gs          , Gs          , Gs^Ft       , Ss          , Hh          , Gs          , Gs          , Gs          , Gs          , Ds          , Gs          , Ww          , Ww          , Hh          , Wwf         , Ww          , Ww          , Wo          , Wo          
Ww          , Ww          , Gs          , Gs          , Ww          , Ww          , Ww          , Wwf         , Wwf         , Gs^Ft       , Ss^Vhs      , Gs^Ft       , Hh          , Gs          , Ce          , Gs          , Gs          , Gs^Ft       , Ss^Vhs      , Hh          , Wwf         , Wwf         , Gs          , Gs^Ft       , Ww^Vm       , Wwf         , Gs          , Ww          , Ww          , Ww          
Ww          , Ww          , Gs          , Ds          , Ww^Vm       , Ww          , Ww          , Gs          , Ww          , Ss          , Ss          , Hh          , Ds          , Ce          , 3 Ke        , Ce          , Gs^Ft       , Ss          , Ww          , Ww          , Ww          , Ds          , Ww          , Ww          , Ww          , Ww          , Mm          , Gs^Ft       , Gs          , Ww          
Ww          , Ww          , Hh          , Ds          , Ds          , Ds          , Gs          , Gs          , Ww          , Ww          , Ww          , Ww          , Ds          , Ce          , Ce          , Ce          , Gs^Ft       , Ww          , Gs          , Gs          , Ww          , Ww          , Hh          , Gs          , Ww          , Ww          , Ww          , Hh^Uf       , Gs          , Ww          
Ww          , Ww          , Gs^Ft       , Hh          , Hh^Uf       , Gs          , Gs^Ft       , Hh          , Ww          , Ww          , Ww          , Ww          , Gs          , Hh          , Gs^Ft       , Ss          , Ss          , Ww          , Gs          , Ds          , Ww          , Ww          , Gs^Uf       , Gs^Ft       , Ww          , Wo          , Ww          , Ds          , Ww          , Ww          
Ww          , Ww          , Ww          , Mm          , Gs^Ft       , Gs^Ft       , Ww          , Ww          , Ww          , Ww          , Gs          , Ww          , Ww          , Gs^Uf       , Ss          , Ss          , Gs^Ft       , Ww          , Ww          , Ww          , Ww          , Ww          , Ww          , Ww          , Wo          , Wo          , Ww          , Ww          , Wo          , Wo          
Wo          , Wo          , Ww          , Hh          , Ww^Vm       , Ww          , Ww          , Ww          , Ds          , Gs          , Gs^Ft       , Ww          , Ww          , Ww          , Ww          , Ww          , Ww          , Ww          , Ww          , Wo          , Wo          , Ww          , Wo          , Ww          , Ww          , Ww          , Ds          , Ww^Vm       , Ww          , Wo          
Wo          , Wo          , Wo          , Ww          , Wo          , Wo          , Wo          , Ww          , Gs          , Gs          , Ww          , Ww          , Wo          , Ww          , Wo          , Ww          , Wo          , Ww          , Wo          , Wo          , Wo          , Wo          , Wo          , Wo          , Ww          , Gs          , Gs          , Gs          , Ww          , Wo          
Wo          , Wo          , Wo          , Ww          , Wo          , Wo          , Wo          , Ww          , Ww          , Ww          , Wo          , Wo          , Wo          , Wo          , Wo          , Wo          , Wo          , Wo          , Wo          , Wo          , Wo          , Wo          , Wo          , Wo          , Wo          , Ww          , Ww          , Ww          , Wo          , Wo          
