border_size=1
usage=map

_off^_usr   , _off^_usr   , _off^_usr   , _off^_usr   , _off^_usr   , _off^_usr   , _off^_usr   , _off^_usr   , _off^_usr   , _off^_usr   , _off^_usr   , _off^_usr   , _off^_usr   , _off^_usr   , _off^_usr   , _off^_usr   , _off^_usr   , _off^_usr   , _off^_usr   , _off^_usr   , _off^_usr   , _off^_usr   , _off^_usr   
_off^_usr   , _off^_usr   , _off^_usr   , _off^_usr   , _off^_usr   , _off^_usr   , _off^_usr   , _off^_usr   , _off^_usr   , _off^_usr   , _off^_usr   , _off^_usr   , _off^_usr   , _off^_usr   , _off^_usr   , _off^_usr   , _off^_usr   , _off^_usr   , _off^_usr   , _off^_usr   , _off^_usr   , _off^_usr   , _off^_usr   
_off^_usr   , _off^_usr   , _off^_usr   , _off^_usr   , _off^_usr   , _off^_usr   , _off^_usr   , _off^_usr   , _off^_usr   , _off^_usr   , Ch          , Mm          , Ch          , _off^_usr   , _off^_usr   , _off^_usr   , _off^_usr   , _off^_usr   , _off^_usr   , _off^_usr   , _off^_usr   , _off^_usr   , _off^_usr   
_off^_usr   , _off^_usr   , _off^_usr   , _off^_usr   , _off^_usr   , _off^_usr   , _off^_usr   , _off^_usr   , Gg          , Hh          , Ch          , 1 Kh        , Ch          , Hh          , Ss          , _off^_usr   , _off^_usr   , _off^_usr   , _off^_usr   , _off^_usr   , _off^_usr   , _off^_usr   , _off^_usr   
_off^_usr   , _off^_usr   , _off^_usr   , _off^_usr   , _off^_usr   , _off^_usr   , Gg          , Gg          , Ww          , Gg          , Gg          , Re          , Re          , Gs^Fp       , Gg          , Gs^Fms      , Re          , _off^_usr   , _off^_usr   , _off^_usr   , _off^_usr   , _off^_usr   , _off^_usr   
_off^_usr   , _off^_usr   , _off^_usr   , _off^_usr   , Re          , Re          , Ss          , Ww          , Ww          , Ww          , Gg          , Gg          , Re          , Gg          , Gg          , Gg          , Gg          , Re          , Hh          , _off^_usr   , _off^_usr   , _off^_usr   , _off^_usr   
_off^_usr   , _off^_usr   , Re          , Re          , Ur          , Ss^Vhs      , Ww          , Ww          , Wwf         , Gg^Ve       , Gg          , Gg          , Gg          , Re          , Gg^Ve       , Gg          , Gg          , Re          , Ch          , Ch          , Mm          , _off^_usr   , _off^_usr   
_off^_usr   , _off^_usr   , Re          , Ur          , Uu^Uf       , Xu          , Wwf         , Ww          , Wwf         , Wwf         , Gg          , Gg          , Gg          , Re          , Gg          , Gg          , Gg          , Re          , Re          , 4 Kh        , Ch          , _off^_usr   , _off^_usr   
_off^_usr   , _off^_usr   , Re          , Ur          , Xu          , Xu          , Mm          , Wwf         , Rr          , Gg          , Ss^Vhs      , Gg^Efm      , Re^Uf       , Re          , Gg          , Gg          , Gs^Fp       , Gg          , Re          , Ch          , Hh          , _off^_usr   , _off^_usr   
_off^_usr   , _off^_usr   , Re          , Uu^Vu       , Gs^Fp       , Rr          , Rr          , Rr          , Chw         , Gg          , Re          , Gs^Fds      , Mm          , Re          , Re          , Gg          , Mm          , Gg^Efm      , Gg          , Re          , Re          , _off^_usr   , _off^_usr   
_off^_usr   , _off^_usr   , Re          , Hh          , Gg          , Gg          , Hh          , Gg          , Gg          , Gg^Fet      , Hh          , Hh          , Gs^Fds      , Hh          , Ss^Vhs      , Gg          , Gs^Fp       , Ss          , Gg          , Gg^Ve       , Re          , _off^_usr   , _off^_usr   
_off^_usr   , _off^_usr   , Re          , Gg          , Gg          , Gg          , Gs^Fp       , Gg          , Ss^Vhs      , Re          , Gs^Fds      , Ww          , Hh          , Re          , Gg          , Gg          , Hh          , Gg          , Gg          , Gg          , Re          , _off^_usr   , _off^_usr   
_off^_usr   , _off^_usr   , Re          , Gg^Ve       , Gg          , Ss          , Mm          , Gg          , Re          , Hh          , Mm          , Hh          , Re          , Gg^Fet      , Chw         , Gg          , Rr          , Gg          , Gs^Fp       , Hh          , Re          , _off^_usr   , _off^_usr   
_off^_usr   , _off^_usr   , Hh          , Re          , Re          , Gg^Efm      , Gs^Fp       , Gg          , Gg          , Re          , Re^Uf       , Gs^Fds      , Ss^Vhs      , Gg          , Rr          , Rr          , Mm          , Rr          , Xu          , Uu^Vu       , Re          , _off^_usr   , _off^_usr   
_off^_usr   , _off^_usr   , Ch          , Ch          , Re          , Gg          , Gg          , Gg          , Gg          , Re          , Gg          , Gg^Efm      , Gg          , Gg          , Wwf         , Wwf         , Wwf         , Xu          , Uu^Uf       , Ur          , Re          , _off^_usr   , _off^_usr   
_off^_usr   , _off^_usr   , Mm          , 3 Kh        , Ch          , Re          , Gg          , Gg          , Gg^Ve       , Re          , Gg          , Gg          , Gg          , Wwf         , Wwf         , Ww          , Ww          , Xu          , Ur          , Ur          , Re          , _off^_usr   , _off^_usr   
_off^_usr   , _off^_usr   , _off^_usr   , Ch          , Hh          , Re          , Gg          , Gg          , Gg          , Re          , Re          , Gg          , Gg          , Gg^Ve       , Ww          , Ww          , Ss          , Ss^Vhs      , Re          , Re          , _off^_usr   , _off^_usr   , _off^_usr   
_off^_usr   , _off^_usr   , _off^_usr   , _off^_usr   , _off^_usr   , Re          , Re          , Gg          , Gg          , Gg          , Re          , Gg          , Gg          , Ww          , Ww          , Ww          , Gg          , Re          , _off^_usr   , _off^_usr   , _off^_usr   , _off^_usr   , _off^_usr   
_off^_usr   , _off^_usr   , _off^_usr   , _off^_usr   , _off^_usr   , _off^_usr   , _off^_usr   , Gs^Fms      , Ss          , Gs^Fp       , Ch          , Re          , Ch          , Gg          , Gg          , Gg          , _off^_usr   , _off^_usr   , _off^_usr   , _off^_usr   , _off^_usr   , _off^_usr   , _off^_usr   
_off^_usr   , _off^_usr   , _off^_usr   , _off^_usr   , _off^_usr   , _off^_usr   , _off^_usr   , _off^_usr   , _off^_usr   , Hh          , Ch          , 2 Kh        , Ch          , Hh          , _off^_usr   , _off^_usr   , _off^_usr   , _off^_usr   , _off^_usr   , _off^_usr   , _off^_usr   , _off^_usr   , _off^_usr   
_off^_usr   , _off^_usr   , _off^_usr   , _off^_usr   , _off^_usr   , _off^_usr   , _off^_usr   , _off^_usr   , _off^_usr   , _off^_usr   , _off^_usr   , Mm          , _off^_usr   , _off^_usr   , _off^_usr   , _off^_usr   , _off^_usr   , _off^_usr   , _off^_usr   , _off^_usr   , _off^_usr   , _off^_usr   , _off^_usr   
_off^_usr   , _off^_usr   , _off^_usr   , _off^_usr   , _off^_usr   , _off^_usr   , _off^_usr   , _off^_usr   , _off^_usr   , _off^_usr   , _off^_usr   , _off^_usr   , _off^_usr   , _off^_usr   , _off^_usr   , _off^_usr   , _off^_usr   , _off^_usr   , _off^_usr   , _off^_usr   , _off^_usr   , _off^_usr   , _off^_usr   
_off^_usr   , _off^_usr   , _off^_usr   , _off^_usr   , _off^_usr   , _off^_usr   , _off^_usr   , _off^_usr   , _off^_usr   , _off^_usr   , _off^_usr   , _off^_usr   , _off^_usr   , _off^_usr   , _off^_usr   , _off^_usr   , _off^_usr   , _off^_usr   , _off^_usr   , _off^_usr   , _off^_usr   , _off^_usr   , _off^_usr   
