border_size=1
usage=map

Xu          , Xu          , Xu          , Xu          , Xu          , Xu          , Xu          , Xu          , Xu          , Wo          , Xu          , Qxu         , Qxu         , Xu          , Xu          , Qlf         , Qlf         , Qlf         , Xu          , Xu          , Xu          , Qlf         , Xu          , Xu          , Xu          , Qlf         , Qlf         , Xu          , Xu          , Xu          , Qxu         , Qxu         , Xu          , Wo          , Xu          , Xu          , Xu          , Xu          , Xu          , Xu          , Xu          , Xu
Xu          , Xu          , Xu          , Xu          , Xu          , Xu          , Xu          , Xu          , Xu          , Wo          , Xu          , Xu          , Uh          , Qxu         , Qxu         , Xu          , Uh          , Xu          , Qxu         , Qxu         , Qxu         , Xu          , Qxu         , Qxu         , Qxu         , Xu          , Uh          , Xu          , Qxu         , Qxu         , Uh          , Xu          , Xu          , Wo          , Xu          , Xu          , Xu          , Xu          , Xu          , Xu          , Xu          , Xu
Xu          , Xu          , Xu          , Xu          , Xu          , Xu          , Xu          , Xu          , Ww          , Wo          , Ww          , Xu          , Mm          , Hhd         , Urb         , Qxu^Bs/     , Qxu         , Qxu^Bs\     , Hhd         , Cud         , Rb^Fdw      , Uu^Uf       , Rb^Fdw      , Cud         , Hhd         , Qxu^Bs/     , Qxu         , Qxu^Bs\     , Ur          , Hhd         , Mm          , Xu          , Ww          , Wo          , Ww          , Xu          , Xu          , Xu          , Xu          , Xu          , Xu          , Xu
Xu          , Xu          , Xu          , Xu          , Xu          , Xu          , Xu          , Uh          , Xu          , Ww          , Ds          , Xu          , Urb         , Urb         , Xos         , Ds          , Re^Vct      , Hhd^Fdw     , Rb          , Rb          , Uh          , Uu          , Uh          , Rb          , Rb          , Hhd^Fdw     , Re^Vct      , Ds          , Ur          , Rb^Fdw      , Urb         , Uu          , Ds          , Ww          , Xu          , Uh          , Uh          , Xu          , Xu          , Xu          , Xu          , Xu
Xu          , Xu          , Xu          , Xu          , Uu          , Xu          , Xu          , Uh          , Uh          , Wwf         , Urb         , Uu          , Urb         , Urb         , Re          , Rd          , Rd          , Re          , Rb          , Ss          , Uu          , Xu          , Uu          , Ss          , Re^Fdw      , Re          , Re          , Re          , Re^Uf       , Urb         , Urb         , Xos         , Urb         , Wwf         , Xu          , Xu          , Uh          , Xu          , Xu          , Xu          , Xu          , Xu
Xu          , Xu          , Ww          , Uh          , Xu          , Ss          , Uu          , Uh          , Xu          , Wwf         , Urb         , Xos         , Cud         , Urb         , Re          , Rd          , Re^Fdw      , Re          , Re          , Hhd         , Rb          , Uu^Uf       , Re          , Re          , Re          , Re          , Re          , Re          , Urb         , Xos         , Cud         , Urb         , Urb         , Wwf         , Uu          , Uh          , Xu          , Uh          , Wwf         , Xu          , Wo          , Wo
Wo          , Wo          , Ww          , Wwf         , Wwf         , Uh          , Xu          , Uh          , Uu          , Wwf         , Urb         , Kud         , Urb         , Urb         , Qxu         , Re          , Re          , Re          , Re          , Re          , Re          , Rb          , Re          , Rd          , Re          , Hhd         , Mm          , Re          , Xos         , Cud         , Kud         , Xos         , Wwf         , Wwf         , Uu^Vud      , Uu          , Wwf         , Wwf         , Hhd         , Ww          , Xu          , Xu
Xu          , Xu          , Xu          , Ds          , Ds          , Wwf         , Wwf         , Uu          , Uu^Vu       , Wwf         , Wwf         , Cud         , Urb         , Urb         , Qxu^Bs\     , Urb         , Urb         , Re          , Aa          , Re          , Rb^Fdw      , Rb          , Hhd         , Re          , Re          , Re^Fdw      , Re          , Re          , Urb         , Urb         , Xos         , Wwf         , Rb          , Wwf         , Wwf         , Wwf         , Xos         , Rb^Fdw      , Mm          , Xu          , Xu          , Xu
Xu          , Xu          , Xu          , Ds          , Xos         , Rb          , Rb          , Wwf         , Wwf         , Wwf         , Wwf         , Xos         , Uu          , Urb         , Qxu         , Urb         , Urb^Vhc     , Aa^Fda      , Rb^Fdw      , Cud         , Xu          , Uu^Uf       , Hhd^Fdw     , Re          , Re          , Re          , Re          , Re          , Xos         , Uu          , Rb          , Wwf         , Wwf         , Wwf         , Rb          , Rb          , Re          , Uu          , Mm          , Xu          , Xu          , Xu
Xu          , Xu          , Xu          , Ds          , Xos         , Xos         , Urb         , Rb          , Rb          , Wwf         , Wwf         , Rb          , Rb          , Xos         , Urb         , Urb         , Urb         , Hhd         , Mm          , Ur          , Uu          , Ur          , Aa^Fda      , Hhd         , Ch          , Hhd^Fdw     , Xos         , Uu          , Rb          , Rb          , Wwf         , Wwf         , Rb^Fdw      , Xos         , Re^Fdw      , Re          , Re          , Xos         , Hhd         , Xu          , Xu          , Xu
Xu          , Xu          , Wo          , Ds          , Rb          , Urb         , Xos         , Xos         , Xos         , Rb          , Rb          , Wwf         , Rb          , Rb          , Mm          , Xos         , Re          , Urb         , Uu^Uf       , Hhd^Fdw     , Ai          , Cud         , Aa          , Rb^Fdw      , Re          , Re^Vct      , Rb          , Rb          , Wwf         , Wwf         , Rb          , Rb          , Uu^Vud      , Uu          , Xos         , Re          , Rb          , Rb          , Wwf         , Wo          , Xu          , Xu
Xu          , Xu          , Cud         , Wwf         , Wwf         , Rb          , Rb          , Xos         , Rb          , Rb^Vct      , Wwf         , Wwf         , Wwf         , Rb          , Hhd         , Re^Fdw      , Rb          , Re          , Re          , Re          , Re          , Re          , Re          , Re          , Rb          , Rb          , Wwf         , Wwf         , Wwf         , Rb          , Hhd^Fdw     , Ur          , Rb          , Rb          , Rb          , Rb          , Wwf         , Wwf         , Rb          , Cud         , Cud         , Xu
Xu          , Cud         , Cud         , Rb          , Rb          , Wwf         , Wwf         , Rb          , Wwf         , Wwf         , Rb          , Rb          , Xos         , Wwf         , Wwf         , Hhd^Vhh     , Wwf         , Rb          , Rb          , Rb          , Wwf         , Re          , Rb          , Rb          , Wwf         , Wwf         , Rb^Fdw      , Hhd^Fdw     , Wwf         , Rb          , Rb          , Rb          , Wwf         , Wwf         , Wwf         , Wwf         , Re^Vct      , Rb          , Re          , Cud         , 3 Kud       , Xu
Xu          , 1 Kud       , Cud         , Re          , Rb          , Rb^Vct      , Wwf         , Wwf         , Xos         , Cud         , Re          , Re          , Uu          , Rb          , Rb          , Wwf         , Rb          , Wwf         , Wwf         , Ww          , Chw         , Ww          , Wwf         , Wwf         , Rb          , Rb          , Hhd         , Hh^Vhh      , Rb          , Wwf         , Wwf         , Wwf         , Kud         , Xos         , Wwf         , Wwf         , Wwf         , Rb          , Rb          , Cud         , Cud         , Xu
Xu          , Cud         , Cud         , Rb          , Wwf         , Wwf         , Rb          , Wwf         , Wwf         , Kud         , Cud         , Re          , Xos         , Re          , Re          , Rb          , Co          , Rb          , Wwf         , Wo          , Xos         , Wo          , Wwf         , Rb          , Co          , Re          , Re          , Re          , Uu          , Xos         , Cud         , Cud         , Wwf         , Wwf         , Rr          , Rr          , Xos         , Wwf         , Wwf         , Cud         , Xu          , Xu
Xu          , Xu          , Wo          , Wwf         , Rb          , Rb          , Uh          , Rb          , Rb          , Wwf         , Wwf         , Cud         , Rb          , Re          , Re^Fdw      , Re          , Re          , Rb^Vct      , Wwf         , Rb^Fdw      , Uu          , Uu^Uf       , Wwf         , Rb^Vct      , Re          , Re          , Uh          , Xos         , Urb         , Cud         , Wwf         , Wwf         , Rb          , Wwf         , Wwf         , Xos         , Xos         , Ur          , Xu          , Wo          , Xu          , Xu
Xu          , Xu          , Xu          , Xu          , Urb         , Xu          , Uu          , Xu          , Uh          , Rb          , Hhd         , Wwf         , Wwf         , Rb          , Rb          , Re          , Re          , Rb          , Rb          , Wwf         , Wwr         , Wwf         , Rb          , Rb          , Rb^Fdw      , Uu          , Urb         , Urb         , Wwf         , Wwf         , Rb          , Rb          , Xu          , Rb          , Rb          , Wwf         , Wwf         , Ur          , Xu          , Xu          , Xu          , Xu
Xu          , Xu          , Uh          , Qxu^Bs/     , Urb         , Uh          , Xu          , Xu          , Uu          , Xu          , Re          , Rb          , Rb          , Wwf         , Wwf         , Mm          , Hhd^Fdw     , Re          , Wwf         , Rb          , Wwf         , Rb          , Wwf         , Wwf         , Wwf         , Urb         , Wwf         , Wwf         , Rb          , Rb          , Re          , Uh          , Uh          , Uu^Uf       , Uh          , Rb          , Rb          , Wwf         , Uu          , Xu          , Xu          , Xu
Xu          , Uh          , Xu          , Qxu         , Uu^Vu       , Urb         , Urb         , Urb         , Xu          , Uh          , Urb         , Re          , Cud         , Rb          , Rb          , Wwf         , Ss^Vhs      , Rb          , Rb          , Hhd         , Hhd^Fdw     , Wwf         , Rb          , Rb          , Rb          , Wwf         , Hhd         , Rb          , Re^Fdw      , Cud         , Hhd^Fdw     , Urb         , Urb         , Xu          , Urb         , Xu          , Cud         , Uu^Vu       , Xu          , Uu          , Uu          , Xu
Xu          , Xu          , Xu          , Xu          , Ql          , Cud         , Uh          , Urb         , Urb         , Urb         , Xos         , Hhd^Fdw     , Rr          , Re^Fdw      , Re          , Rb          , Rb          , Wwf         , Wwf         , Rb^Fdw      , Wwf         , Cud         , Wwf         , Rb          , Re          , Hhd^Vhh     , Re          , Re          , Rr          , Rr          , Rr          , Xos         , Rr          , Urb         , Qxu         , Urb         , Uu^Uf       , Ql          , Xu          , Xu          , Uu          , Xu
Xu          , Xu          , Uh^Ii       , Xu          , Xu          , Uu^Uf       , Qxu         , Qxu         , Xos         , Rr          , Rr          , Rr          , Xos         , Rr          , Mm          , Re          , Hhd^Fdw     , Rb          , Rb          , Wwf         , Ai          , Wwf         , Wwf         , Rb          , Re          , Re          , Mm          , Rb^Fdw      , Cud         , Xos         , Gg^Fet      , Rr          , Kud         , Xos         , Xos         , Qxu         , Aa          , Xu          , Uh^Ii       , Uh          , Xu          , Xu
Xu          , Xu          , Uh          , Xu          , Xu          , Aa          , Qxu         , Xos         , Xos         , Kud         , Rr          , Gg^Fet      , Xos         , Cud         , Rb^Fdw      , Mm          , Re          , Re          , Rb          , Wwf         , Wwf         , Ai          , Wwf         , Rb          , Rb          , Hhd^Fdw     , Re          , Mm          , Rr          , Xos         , Rr          , Rr          , Rr          , Xos         , Qxu         , Qxu         , Uu^Uf       , Xu          , Xu          , Xu          , Ql          , Ql
Xu          , Uh          , Xu          , Xu          , Ql          , Uu^Uf       , Urb         , Qxu         , Urb         , Rr          , Xos         , Rr          , Rr          , Rr          , Re          , Re          , Hhd^Vhh     , Re          , Rb          , Wwf         , Cud         , Wwf         , Rb^Fdw      , Wwf         , Wwf         , Rb          , Rb          , Re          , Re^Fdw      , Rr          , Hhd^Fdw     , Xos         , Urb         , Urb         , Urb         , Uh          , Cud         , Ql          , Ql          , Ql          , Cud         , Ql
Xu          , Uu          , Xu          , Xu          , Uu^Vu       , Cud         , Xu          , Urb         , Xu          , Urb         , Urb         , Hhd^Fdw     , Cud         , Re^Fdw      , Rb          , Hhd         , Wwf         , Rb          , Rb          , Rb          , Wwf         , Hhd^Fdw     , Hhd         , Rb          , Rb          , Ss^Vhs      , Wwf         , Rb          , Rb          , Cud         , Rb          , Urb         , Uh          , Xu          , Urb         , Urb         , Urb         , Uu^Vu       , Xu          , Uu          , Uh          , Ql
Xu          , Ww          , Uh          , Xu          , Wwf         , Rb          , Rb          , Uh          , Uu^Uf       , Uh          , Uh          , Rb          , Rb          , Rb          , Wwf         , Wwf         , Urb         , Wwf         , Wwf         , Wwf         , Rb          , Wwf         , Rb          , Wwf         , Re          , Hhd^Fdw     , Mm          , Wwf         , Wwf         , Rb          , Rb          , Rb          , Xu          , Uu          , Xu          , Xu          , Uh          , Urb         , Uu          , Ur          , Uh          , Xu
Xu          , Xu          , Xu          , Uh          , Urb         , Wwf         , Wwf         , Rb          , Rb          , Xu          , Rb          , Rb          , Wwf         , Wwf         , Urb         , Urb         , Uu          , Rb^Fdw      , Rb          , Rb          , Wwf         , Wwr         , Wwf         , Rb          , Rb          , Re          , Re          , Rb          , Rb          , Wwf         , Wwf         , Hhd         , Rb          , Uh          , Xu          , Uu          , Xu          , Urb         , Xu          , Xu          , Xu          , Xu
Xu          , Xu          , Wo          , Xu          , Urb         , Xos         , Xos         , Wwf         , Wwf         , Rb          , Wwf         , Wwf         , Cud         , Urb         , Xos         , Uh          , Re          , Re          , Rb^Vct      , Wwf         , Uu^Uf       , Uu          , Rb^Fdw      , Wwf         , Rb^Vct      , Re          , Re          , Re^Fdw      , Re          , Rb          , Cud         , Wwf         , Wwf         , Rb          , Rb          , Uh          , Rb          , Rb          , Wwf         , Wo          , Xu          , Xu
Xu          , Xu          , Cud         , Wwf         , Wwf         , Xos         , Rb          , Rb          , Wwf         , Wwf         , Cud         , Cud         , Xos         , Uu          , Re          , Re          , Re          , Co          , Rb          , Wwf         , Wo          , Xos         , Wo          , Wwf         , Rb          , Co          , Rb          , Re          , Re          , Xos         , Re          , Cud         , Kud         , Wwf         , Wwf         , Rb          , Wwf         , Wwf         , Rb          , Cud         , Cud         , Xu
Xu          , Cud         , Cud         , Rb          , Rb          , Wwf         , Wwf         , Wwf         , Xos         , Kud         , Wwf         , Wwf         , Wwf         , Rb          , Hhd^Vo      , Hhd         , Rb          , Rb          , Wwf         , Wwf         , Ww          , Chw         , Ww          , Wwf         , Wwf         , Rb          , Wwf         , Rb          , Rb          , Uu          , Re          , Re          , Cud         , Xos         , Wwf         , Wwf         , Rb^Vct      , Rb          , Re          , Cud         , 2 Kud       , Xu
Xu          , 4 Kud       , Cud         , Re          , Rb          , Rb^Vct      , Wwf         , Wwf         , Wwf         , Wwf         , Rb          , Rb          , Rb          , Wwf         , Hhd^Fdw     , Rb^Fdw      , Wwf         , Wwf         , Rb          , Rb          , Rb          , Wwf         , Rb          , Rb          , Rb          , Wwf         , Hhd^Vhh     , Wwf         , Wwf         , Xos         , Rb          , Rb          , Wwf         , Wwf         , Rb          , Wwf         , Wwf         , Rb          , Rb          , Cud         , Cud         , Xu
Xu          , Cud         , Cud         , Rb          , Wwf         , Wwf         , Rb          , Rb          , Rb          , Rb          , Ur          , Hhd^Fdw     , Rb          , Wwf         , Wwf         , Wwf         , Rb          , Rb          , Rb          , Rb          , Rb          , Rb          , Re          , Re          , Re          , Rb          , Re^Fdw      , Hhd         , Rb          , Wwf         , Wwf         , Wwf         , Rb^Vct      , Rb          , Xos         , Rb          , Rb          , Wwf         , Wwf         , Cud         , Xu          , Xu
Xu          , Xu          , Wo          , Wwf         , Rb          , Rb          , Re          , Xos         , Uu          , Uu^Vud      , Rb          , Rb          , Wwf         , Wwf         , Rb          , Rb          , Re^Vct      , Rb          , Rb^Fdw      , Aa          , Cud         , Ai          , Hhd^Fdw     , Uu^Uf       , Urb         , Re          , Xos         , Mm          , Rb          , Rb          , Wwf         , Rb          , Rb          , Xos         , Xos         , Xos         , Urb         , Rb          , Ds          , Wo          , Xu          , Xu
Xu          , Xu          , Xu          , Hhd         , Xos         , Re          , Re          , Re^Fdw      , Xos         , Rb^Fdw      , Wwf         , Wwf         , Rb          , Rb          , Uu          , Xos         , Hhd^Fdw     , Ch          , Hhd         , Aa^Fda      , Ur          , Uu          , Ur          , Mm          , Hhd         , Urb         , Urb         , Urb         , Xos         , Rb          , Rb          , Wwf         , Wwf         , Rb          , Rb          , Urb         , Xos         , Xos         , Ds          , Xu          , Xu          , Xu
Xu          , Xu          , Xu          , Mm          , Uu          , Re          , Rb          , Rb          , Wwf         , Wwf         , Wwf         , Rb          , Uu          , Xos         , Re          , Re          , Re          , Re          , Re          , Hhd^Fdw     , Uu^Uf       , Xu          , Cud         , Rb^Fdw      , Aa^Fda      , Urb^Vhc     , Urb         , Qxu         , Urb         , Uu          , Xos         , Wwf         , Wwf         , Wwf         , Wwf         , Rb          , Rb          , Xos         , Ds          , Xu          , Xu          , Xu
Xu          , Xu          , Xu          , Mm          , Rb^Fdw      , Xos         , Wwf         , Wwf         , Wwf         , Rb          , Wwf         , Xos         , Urb         , Re          , Re          , Re          , Re^Fdw      , Re          , Re          , Hhd         , Rb          , Rb^Fdw      , Re          , Aa          , Re          , Urb         , Urb         , Qxu^Bs\     , Urb         , Urb         , Cud         , Wwf         , Wwf         , Uu^Vu       , Uu          , Wwf         , Wwf         , Ds          , Ds          , Xu          , Xu          , Xu
Xu          , Xu          , Ww          , Hh          , Wwf         , Wwf         , Uu          , Uu^Vud      , Wwf         , Wwf         , Xol         , Kud         , Cud         , Xos         , Re          , Mm          , Hhd         , Re          , Rd          , Re          , Rb          , Rb          , Re          , Re          , Re          , Re          , Re          , Qxu         , Urb         , Urb         , Kud         , Urb         , Wwf         , Uu          , Uh          , Xu          , Uh          , Wwf         , Wwf         , Ww          , Wo          , Wo
Wo          , Wo          , Xu          , Wwf         , Xu          , Xu          , Uh          , Uu          , Wwf         , Urb         , Urb         , Cud         , Xos         , Urb         , Re          , Re          , Re          , Re          , Re          , Re          , Uu^Uf       , Rb          , Hhd         , Re          , Re          , Re^Fdw      , Re          , Re          , Urb         , Cud         , Xos         , Urb         , Wwf         , Xu          , Xu          , Uh          , Xu          , Uh          , Xu          , Ww          , Xu          , Xu
Xu          , Xu          , Xu          , Xu          , Xu          , Xu          , Xu          , Xu          , Wwf         , Urb         , Xos         , Urb         , Urb         , Re^Uf       , Rd          , Re          , Re          , Re^Fdw      , Ss          , Uu          , Xu          , Uu          , Ss          , Rb          , Re          , Rd          , Rd          , Re          , Re          , Urb         , Uu          , Urb         , Wwf         , Uh          , Uh          , Uh          , Xu          , Xu          , Xu          , Xu          , Xu          , Xu
Xu          , Xu          , Uh          , Xu          , Uu          , Uh          , Xu          , Ww          , Chw         , Ww          , Uu          , Urb         , Ur          , Rd          , Ds          , Re^Vct      , Hhd^Fdw     , Rb          , Rb          , Uh          , Uu          , Uh          , Rb          , Rb          , Hhd^Fdw     , Re^Vct      , Ds          , Xos         , Re^Fdw      , Re^Fdw      , Xu          , Ds          , Ww          , Xu          , Uu          , Xu          , Xu          , Xu          , Xu          , Xu          , Xu          , Xu
Xu          , Qxu         , Uu^Dr       , Uu          , Uu          , Xu          , Xu          , Ww          , Ww          , Ww          , Xu          , Rb^Fdw      , Mm          , Ur          , Qxu^Bs\     , Qxu         , Qxu^Bs/     , Hhd         , Cud         , Rb^Fdw      , Uu^Uf       , Rb^Fdw      , Cud         , Hhd         , Qxu^Bs\     , Qxu         , Qxu^Bs/     , Re          , Re^Fdw      , Mm          , Xu          , Ww          , Wo          , Ww          , Xu          , Xu          , Xu          , Xu          , Xu          , Xu          , Xu          , Xu
Cud         , Qxu         , Uh          , Uh^Ii       , Qxu         , Uh          , Xu          , Xu          , Wo          , Xu          , Xu          , Uh          , Qxu         , Qxu         , Xu          , Uh          , Xu          , Qxu         , Qxu         , Qxu         , Xu          , Qxu         , Qxu         , Qxu         , Xu          , Uh          , Xu          , Qxu         , Qxu         , Uh          , Xu          , Xu          , Wo          , Xu          , Xu          , Xu          , Xu          , Xu          , Xu          , Xu          , Xu          , Xu
Cud         , Qxu^Bs/     , Qxu         , Qxu         , Qxu         , Xu          , Xu          , Xu          , Wo          , Xu          , Qxu         , Qxu         , Xu          , Xu          , Qlf         , Qlf         , Qlf         , Xu          , Xu          , Xu          , Qlf         , Xu          , Xu          , Xu          , Qlf         , Qlf         , Xu          , Xu          , Xu          , Qxu         , Qxu         , Xu          , Wo          , Xu          , Xu          , Xu          , Xu          , Xu          , Xu          , Xu          , Xu          , Xu
