border_size=1
usage=map

Xu          , Xu          , Xu          , Xu          , Xu          , Xu          , Xu          , Xu          , Xu          , Xu          , Xu          , Xu          , Xu          , Xu          , Xu          , Xu          , Xu          , Xu          , Xu          , Xu          , Xu          , Xu          , Xu          , Xu          , Xu          , Xu          , Xu          , Xu          , Xu          
Xu          , Xu          , Xu          , Xu          , Xu          , Xu          , Xu          , Xu          , Xu          , Xu          , Xu          , Xu          , Xu          , Xu          , Xu          , Xu          , Xu          , Xu          , Xu          , Xu          , Xu          , Xu          , Xu          , Xu          , Xu          , Xu          , Xu          , Xu          , Xu          
Xu          , Xu          , Xu          , Xu          , Xu          , Xu          , Xu          , Xu          , Xu          , Xu          , Xu          , Xu          , Xu          , Xu          , Xu          , Xu          , Xu          , Xu          , Xu          , Xu          , Xu          , Xu          , Xu          , Xu          , Xu          , Xu          , Xu          , Xu          , Xu          
Xu          , Xu          , Xu          , Xu          , Xu          , Xu          , Xu          , Xu          , Xu          , Xu          , Xu          , Xu          , Xu          , Xu          , Qxu         , Qxu         , Qxu         , Xu          , Xu          , Xu          , Xu          , Xu          , Xu          , Xu          , Xu          , Xu          , Xu          , Xu          , Xu          
Xu          , Xu          , Xu          , Xu          , Xu          , Xu          , Xu          , Xu          , Xu          , Xu          , Xu          , Xu          , Uu^Uf       , Uh          , Uu          , Cud         , Re          , Uh          , Uu^Uf       , Xu          , Xu          , Xu          , Xu          , Xu          , Xu          , Xu          , Xu          , Xu          , Xu          
Xu          , Xu          , Xu          , Xu          , Xu          , Xu          , Xu          , Xu          , Wo          , Xu          , Uh          , Xu          , Gg          , Gg          , Gg          , Gg          , Re          , Re          , Re          , Uu          , Xu          , Xu          , Xu          , Xu          , Uu          , Xu          , Xu          , Xu          , Xu          
Xu          , Xu          , Xu          , Xu          , Uh          , Xu          , Uh          , Wo          , Wo          , Ss          , Ss^Vhs      , Gs^Fp       , Re          , Re          , Re          , Re          , Hh          , Gg          , Gg          , Re          , Gg          , Xu          , Wo          , Uh          , Uu^Vu       , Rr          , Xu          , Xu          , Xu          
Rr          , Rr          , Rr          , Rr          , Uu          , Uu^Vu       , Wwf         , Wwf         , Gg          , Gg          , Gg          , Gg          , Gg          , Gg          , Hh          , Gg^Fet      , Gs^Fp       , Mm          , Rr          , Gg          , Gg          , Wo          , Wo          , Wo          , Wwf         , Rr          , Rr          , Xu          , Xu          
Xu          , Uh          , Cud         , Uu          , Cud         , Wwf         , Wwf         , Wwf         , Ss          , Rr          , Wwf         , Rr          , Rr          , Rr          , Gg          , Gg          , Wwf         , Rr          , Hh          , Gg          , Wwf         , Wwf         , Gs^Fp       , Wwf         , Cud         , Cud         , Cud         , Xu          , Uh          
Xu          , Xu          , Cud         , 1 Kud       , Cud         , Rr          , Rr          , Ww          , Rr          , Chs         , Wwf         , Wwf         , Wwf         , Wwf         , Wwf         , Wwf         , Wwf         , Wwf         , Wwf         , Ss^Vhs      , Ss          , Rr          , Rr          , Gg          , Rr          , 3 Kud       , Cud         , Uh          , Rr          
Xu          , Xu          , Re          , Gg          , Gg          , Gg          , Gg          , Gg          , Gg          , Gs^Fp       , Hh          , Gg          , Gg^Vc       , Wwf         , Hh          , Wwf         , Gs^Fp       , Gs^Fp       , Re          , Gg          , Gg          , Gg          , Re          , Rr          , Gg^Vc       , Rr          , Rr          , Rr          , Xu          
Xu          , Xu          , Re          , Gg^Vc       , Gg          , Gg          , Re          , Re          , Re          , Gg          , Re          , Re          , Gs^Fp       , Hh          , Mm          , Chw         , Hh          , Re          , Gg          , Re          , Re          , Re          , Hh          , Re          , Gg          , Gg          , Rr          , Xu          , Xu          
Xu          , Xu          , Gg          , Re          , Re          , Gs^Fp       , Hh          , Re          , Gg          , Re          , Gg          , Re          , Re          , Re          , Re          , Gg          , Gg          , Gg          , Gg^Vc       , Gg          , Gg          , Gg          , Gg          , Gg          , Rr          , Rr          , Qxu         , Xu          , Xu          
Xu          , Xu          , Xu          , Hh          , Mm          , Gs^Fp       , Gg          , Hh^Vhh      , Gg          , Gg          , Hh          , Gg          , Hh          , Gg          , Wwf         , Wwf         , Wwf         , Wwf         , Hh          , Gg          , Rr          , Rr          , Wwf         , Gs^Fp       , Uu^Vud      , Uh          , Qxu         , Xu          , Xu          
Xu          , Xu          , Xu          , Xu          , Wwf         , Gg          , Wo          , Gg          , Gg          , Mm          , Gg^Fet      , Rr          , Rr          , Rr          , Wo^Bw\      , Wo          , Rr          , Gs^Fp       , Gg^Fet      , Rr          , Gg          , Wo          , Wo          , Wwf         , Wwf         , Xu          , Xu          , Xu          , Xu          
Xu          , Xu          , Qxu         , Xu          , Uu^Vud      , Wwf         , Wwf         , Wo          , Rr          , Rr          , Hh          , Gs^Fp       , Wwf         , Wo          , Wwf         , Rr          , Hh          , Rr          , Hh          , Mm          , Gg          , Gg          , Gg          , Gg          , Mm          , Xu          , Xu          , Xu          , Xu          
Xu          , Xu          , Qxu         , Uh          , Rr          , Gs^Fp       , Gg          , Rr          , Gg          , Gg          , Gg^Vc       , Wwf         , Gg          , Wwf         , Re          , Gg          , Re          , Gg          , Gg          , Gg          , Gg          , Hh^Vhh      , Hh          , Gs^Fp       , Re          , Hh          , Gg          , Xu          , Xu          
Xu          , Xu          , Rr          , Rr          , Gg          , Gg          , Hh          , Gg          , Re          , Gg          , Gg          , Gg          , Hh          , Gg          , Mm          , Re          , Gs^Fp       , Re          , Re          , Re          , Re          , Re          , Re          , Gs^Fp       , Gg          , Re          , Re          , Xu          , Xu          
Xu          , Xu          , Rr          , Gg          , Gg^Vc       , Re          , Re          , Re          , Gg          , Re          , Re          , Re          , Gs^Fp       , Chw         , Hh          , Hh          , Gg^Vc       , Re          , Hh          , Gg          , Gg          , Re          , Gg          , Gg          , Gg          , Gg^Vc       , Re          , Xu          , Xu          
Rr          , Rr          , Cud         , Rr          , Rr          , Rr          , Rr          , Gg          , Ss          , Gg          , Wwf         , Gs^Fp       , Wwf         , Wwf         , Wwf         , Wwf         , Wwf         , Gg          , Wwf         , Gs^Fp       , Rr          , Gg          , Rr          , Gg          , Cud         , Gg          , Cud         , Xu          , Xu          
Uh          , Uh          , Cud         , 4 Kud       , Cud         , Gg          , Gs^Fp       , Rr          , Wwf         , Ss^Vhs      , Hh          , Wwf         , Wwf         , Wwf         , Gg          , Wwf         , Rr          , Wwf         , Wwf         , Chs         , Ss          , Ww          , Wwf         , Rr          , Cud         , 2 Kud       , Cud         , Xu          , Xu          
Xu          , Xu          , Rr          , Cud         , Wwf         , Wwf         , Wo          , Wwf         , Gg          , Gs^Fp       , Rr          , Rr          , Gs^Fp       , Gg          , Hh          , Rr          , Gg          , Rr          , Gg          , Rr          , Gg          , Wwf         , Wwf         , Wwf         , Uu          , Uu          , Rr          , Uh          , Rr          
Xu          , Xu          , Xu          , Rr          , Uu^Vu       , Wo          , Wo          , Wo          , Gg          , Gg          , Gg          , Mm          , Hh          , Gg^Fet      , Re          , Gg          , Re          , Gg          , Ss^Vhs      , Gg          , Wo          , Wwf         , Uh          , Uu^Vu       , Uh          , Rr          , Xu          , Rr          , Xu          
Xu          , Xu          , Xu          , Rr          , Uu          , Uh          , Xu          , Xu          , Xu          , Re          , Re          , Gg          , Re          , Re          , Gg          , Re          , Gg          , Gs^Fp       , Uh          , Ss          , Wo          , Wo          , Xu          , Xu          , Xu          , Xu          , Xu          , Xu          , Xu          
Xu          , Xu          , Xu          , Xu          , Xu          , Xu          , Xu          , Xu          , Xu          , Uu          , Uu^Uf       , Re          , Re          , Gg          , Uu          , Gg          , Uu^Uf       , Xu          , Xu          , Xu          , Xu          , Xu          , Xu          , Xu          , Xu          , Xu          , Xu          , Xu          , Xu          
Xu          , Xu          , Xu          , Xu          , Xu          , Xu          , Xu          , Xu          , Xu          , Xu          , Xu          , Uh          , Qxu         , Cud         , Qxu         , Uh          , Xu          , Xu          , Xu          , Xu          , Xu          , Xu          , Xu          , Xu          , Xu          , Xu          , Xu          , Xu          , Xu          
Xu          , Xu          , Xu          , Xu          , Xu          , Xu          , Xu          , Xu          , Xu          , Xu          , Xu          , Xu          , Xu          , Qxu         , Xu          , Xu          , Xu          , Xu          , Xu          , Xu          , Xu          , Xu          , Xu          , Xu          , Xu          , Xu          , Xu          , Xu          , Xu          
Xu          , Xu          , Xu          , Xu          , Xu          , Xu          , Xu          , Xu          , Xu          , Xu          , Xu          , Xu          , Xu          , Xu          , Xu          , Xu          , Xu          , Xu          , Xu          , Xu          , Xu          , Xu          , Xu          , Xu          , Xu          , Xu          , Xu          , Xu          , Xu          
Xu          , Xu          , Xu          , Xu          , Xu          , Xu          , Xu          , Xu          , Xu          , Xu          , Xu          , Xu          , Xu          , Xu          , Xu          , Xu          , Xu          , Xu          , Xu          , Xu          , Xu          , Xu          , Xu          , Xu          , Xu          , Xu          , Xu          , Xu          , Xu          
