border_size=1
usage=map

Re^Uf       , Gs^Fp       , Mm          , Hh          , Re^Uf       , Hh          , Ww          , Ww          , Hh          , Hh          , Ww          , Ww          , Mm          , Hh          , Gs^Fms      , Ss          , Gs^Fp       , Hh          , Gs^Fp       , Hh          , Ss          , Gs^Fp       , Hh          , Wo          , Wo          , Wo          , Ww          , Gs^Fp       , Mm          , Re          , Hh          , Hh          
Gs^Fp       , Gs^Fp       , Mm          , Re^Uf       , Gs^Fp       , Hh          , Ww          , Hh          , Gs^Fds      , Gs^Fms      , Ww          , Gs^Fp       , Mm          , Hh          , Gs^Fp       , Hh          , Gs^Fms      , Hh          , Gs^Fp       , Hh          , Gg          , Gs^Fp       , Hh          , Ww          , Ww          , Wo          , Ww          , Gs^Fp       , Mm          , Re          , Hh          , Hh          
Mm          , Mm          , Mm          , Mm          , Ww          , Ww          , Gg          , Gg          , Gg          , Ww          , Ww          , Gs^Fds      , Gs^Fms      , Mm          , Mm          , Gg          , Gg          , Gs^Fp       , Re          , Gg          , Re          , Gs^Fms      , Gs^Fp       , Gs^Fds      , Hh          , Ww          , Ww          , Ww          , Ww^Bw/      , Re          , Hh^Vhh      , Hh          
Hh          , Hh          , Ss          , Ww          , Ww^Vm       , Gg          , Re          , Re          , Re          , Re          , Re          , Gg^Vh       , Hh          , Gs^Fp       , Ss          , Gg          , Re          , Re          , Gg          , Re          , Hh^Vhh      , Re          , Gg          , Gg          , Re          , Gg          , Re          , Ww^Bw/      , Ww          , Gg          , Gs^Fp       , Gs^Fp       
Gs^Fp       , Gs^Fp       , Gs^Fp       , Ww          , Re          , Re          , Re^Uf       , Hh          , Gs^Fp       , Gg          , Gg          , Re          , Ch          , Ch          , Ch          , Gg          , Re          , Hh          , Re^Uf       , Hh          , Gs^Fp       , Re          , Re          , Re          , Gs^Fms      , Re          , Gs^Fp       , Ww          , Ww          , Gg          , Gs^Fds      , Gs^Fp       
Gs^Fp       , Gs^Fms      , Ss          , Re          , Hh          , Ss          , Gs^Fp       , Mm          , Mm          , Gs^Fp       , Gg          , Re          , Ch          , 4 Kh        , Ch          , Re          , Gs^Fds      , Re^Uf       , Hh          , Mm          , Gg          , Gs^Fp       , Re          , Hh          , Gg          , Re          , Hh          , Ww^Vm       , Ww          , Gg          , Hh          , Hh          
Re          , Re          , Re          , Re          , Gs^Fp       , Hh          , Hh          , Re^Uf       , Gs^Fds      , Hh          , Rp          , Rp          , Rp          , Rp          , Rp          , Rp          , Rp          , Gs^Fp       , Gg^Vh       , Gg          , Re          , Re          , Hh          , Gs^Fp       , Ww          , Ww^Bw|      , Ww          , Ww          , Ww          , Gg          , Gg          , Gg          
Gg          , Gg          , Re          , Hh          , Rd          , Rd          , Rd          , Gs^Fms      , Gg          , Gg          , Rp          , Gg          , Gs^Fp       , Gs^Fds      , Gg          , Hh          , Hh          , Rp          , Rp          , Re          , Gg          , Gg          , Gg          , Ww          , Ww          , Ww^Bw|      , Ww          , Ww          , Ch          , Wwf         , Gg          , Gg          
Gs^Fp       , Gs^Fp       , Gg^Ve       , Re          , Re^Uf       , Hh          , Gs^Fp       , Rd          , Rp          , Rp          , Gg^Ve       , Gs^Fms      , Ww          , Mm          , Gg          , Mm          , Hh^Uf       , Mm          , Rp          , Gs^Fp       , Gg          , Gg          , Wwf         , Ww          , Gg          , Re          , Ch          , Ch          , Ch          , Wwf         , Ds          , Ds          
Hh          , Hh          , Re          , Re          , Gs^Fp       , Mm          , Ww          , Gg          , Rp          , Gs^Fds      , Hh          , Hh          , Rd          , Hh          , Gg          , Gs^Fp       , Rp          , Rp          , Gs^Fms      , Gs^Fp       , Ww          , Wwf         , Gg          , Hh          , Re          , Re          , Re          , 1 Kh        , Ch          , Wwf         , Wwf         , Wwf         
Gs^Fp       , Gs^Fp       , Re          , Ww          , Gs^Fms      , Mm          , Hh          , Rp          , Gs^Fp       , Rd          , Rd          , Rd          , Gg          , Rd          , Rp          , Rp          , Hh          , Gg          , Hh          , Gg          , Ww          , Wwf         , Hh          , Re          , Gg          , Gg          , Gg          , Re          , Rp          , Gg          , Gg          , Gg          
Ss          , Ss          , Gg          , Re          , Gg          , Re^Uf       , Hh          , Rp          , Gg          , Gg          , Gs^Fds      , Hh          , Hh          , Gg          , Rp          , Gg^Vh       , Gs^Fms      , Mm          , Gg          , Wwf         , Ww          , Mm          , Gs^Fp       , Re          , Gg^Ve       , Gs^Fp       , Mm          , Gg          , Rp          , Gs^Fp       , Hh          , Hh          
Ss          , Ss          , Mm          , Re          , Gg          , Gg          , Gs^Fp       , Rp          , Gg          , Gs^Fms      , Gs^Fp       , Mm          , Ss          , Gs^Fp       , Ww^Bw|      , Hh          , Ww          , Hh          , Wwf         , Ww^Vm       , Ww          , Gs^Fms      , Re          , Re          , Hh          , Hh          , Gs^Fms      , Gs^Fms      , Rp          , Hh          , Gs^Fp       , Gs^Fp       
Ss          , Ss          , Hh          , Re          , Re          , Gg          , Rp          , Rp          , Re          , Gg          , Ss^Vhs      , Hh          , Ss          , Ss          , Chs         , Ss          , Chw         , Ww          , Ww          , Wwf         , Gg          , Gs^Fds      , Re          , Gg          , Gs^Fp       , Re^Uf       , Hh          , Gs^Fds      , Rp          , Gg          , Hh          , Hh          
Gs^Fp       , Gs^Fp       , Gs^Fms      , Gg^Vh       , Gg          , Rp          , Gs^Fp       , Hh          , Hh          , Re          , Gs^Fms      , Ss          , Ww          , Gg          , Gg          , Chr         , Khw         , Chw         , Ww          , Ww          , Hh          , Re          , Mm          , Mm          , Mm          , Hh          , Rd          , Rd          , Gg^Vh       , Rp          , Gs^Fp       , Gs^Fp       
Gs^Fp       , Re^Uf       , Hh          , Gg          , Gs^Fp       , Rp          , Rp          , Gg          , Mm          , Re          , Re          , Hh          , Mm          , Wwf         , Hh          , Chr         , Ww          , Ww^Bw\      , Gs^Fp       , Gs^Fp       , Hh^Vhh      , Re          , Gs^Fp       , Mm          , Gs^Fds      , Rd          , Gg          , Gs^Fp       , Hh          , Rp          , Gg          , Gg          
Hh          , Hh          , Gg          , Gg          , Ch          , Ch          , Ch          , Rp          , Gg          , Gg          , Ww^Bw|      , Gs^Fp       , Ww          , Wwf         , Wwf         , Gs^Fp       , Ww          , Ww          , Ww          , Hh          , Gs^Fds      , Re          , Re          , Gs^Fms      , Rd          , Rd          , Ss          , Gg          , Rp          , Rp          , Gg          , Gg          
Gs^Fp       , Gs^Fp       , Hh          , Ch          , Ch          , 2 Kh        , Ww          , Rp          , Ww          , Ww          , Ww^Bw|      , Ww          , Ww          , Wwf         , Gg          , Wwf         , Gg          , Ww          , Ww          , Ww          , Gs^Fp       , Re^Uf       , Hh          , Re          , Gs^Fp       , Hh          , Ss          , Hh          , Rp          , Gg          , Gs^Fms      , Gs^Fp       
Hh          , Hh          , Gg          , Gg          , Ww          , Ww          , Ww          , Ww^Bw|      , Ww          , Ww          , Re          , Ww          , Gs^Fp       , Hh          , Gg^Vh       , Gg          , Hh          , Gg          , Wwf         , Ww          , Gs^Fp       , Mm          , Gs^Fms      , Re          , Ss^Vhs      , Ss          , Ss          , Gs^Fp       , Rp          , Gs^Fp       , Re^Uf       , Gs^Fp       
Ds          , Ds          , Wwf         , Ww          , Ww          , Ww          , Gs^Fp       , Ww^Bw|      , Gg          , Gg          , Re          , Gg          , Re          , Gs^Fp       , Gg          , Re          , Hh          , Wwf         , Ww^Vm       , Ww          , Gg          , Gg          , Re          , Re          , Re          , Re^Uf       , Hh          , Gs^Fp       , Rp          , Hh^Vhh      , Hh          , Hh          
Wwf         , Wwf         , Wwf         , Wwf         , Gg          , Hh          , Hh          , Re          , Gg^Ve       , Hh          , Ww          , Re          , Mm          , Re          , Re          , Re          , Hh          , Wwf         , Ww          , Gg          , Re          , Re          , Mm          , Mm          , Gs^Fp       , Re          , Rp          , Rp          , Ch          , Ww          , Mm          , Mm          
Wwf         , Wwf         , Gg          , Gg          , Gs^Fds      , Gs^Fms      , Re          , Re          , Rd          , Gs^Fp       , Gs^Fp       , Hh          , Gs^Fds      , Gs^Fp       , Re          , Gg          , Gs^Fp       , Ww          , Ww^Bw/      , Ww^Bw/      , Gg          , Mm          , Hh          , Hh          , Gs^Fp       , Gg          , Rp          , Ch          , Ch          , Ww          , Gs^Fp       , Gs^Fp       
Gs^Fp       , Gs^Fp       , Gs^Fms      , Gg          , Re          , Re          , Gg          , Gg          , Hh          , Rd          , Rd          , Rd          , Rd          , Rd          , Mm          , Re          , Re          , Re          , Ww          , Ww          , Gs^Fp       , Gs^Fp       , Gg^Vh       , Gs^Fds      , Rp          , Rp          , Gg          , 3 Kh        , Ch          , Gs^Fp       , Gs^Fds      , Gs^Fp       
Gs^Fp       , Re^Uf       , Hh          , Hh^Vhh      , Re          , Gg          , Mm          , Gs^Fms      , Mm          , Gg^Uf       , Gs^Fp       , Gg          , Rd          , Mm          , Mm          , Mm          , Hh          , Gg          , Ww          , Ww          , Ww^Bw/      , Rp          , Rp          , Rp          , Gg          , Gg          , Hh          , Ch          , Rd          , Mm          , Hh          , Hh          
Xu          , Xu          , Uu          , Gg          , Re          , Gs^Fp       , Hh          , Gs^Fp       , Ww          , Mm          , Re^Uf       , Hh          , Gg^Vh       , Rd          , Gs^Fp       , Gs^Fp       , Hh          , Gg          , Rp          , Ww^Bw/      , Ww          , Hh          , Gs^Fp       , Mm          , Gg          , Gg          , Gs^Fp       , Gg          , Rd          , Gg          , Ww          , Ww          
Xu          , Xu          , Rd          , Rd          , Xu          , Re          , Gg          , Ww          , Ww          , Gs^Fp       , Hh          , Gs^Fds      , Re          , Re          , Re          , Gg          , Rp          , Rp          , Gs^Fp       , Ww          , Ww^Vm       , Ww          , Ww          , Gg          , Wwf         , Wwf         , Ww^Vm       , Ww          , Ww^Bw|      , Ww          , Gs^Fds      , Gs^Fp       
Uu          , Uu          , Rd          , Uu^Uf       , Qxu         , Re          , Re          , Gg          , Re          , Gg          , Re          , Re          , Ch          , Gg          , Gg          , Rp          , Gg          , Gg^Ve       , Hh          , Hh          , Gs^Fp       , Ww          , Gs^Fp       , Wwf         , Gg          , Gg          , Hh          , Gg          , Rd          , Gg          , Gs^Fms      , Gs^Fp       
Uu          , Uu          , Rd          , Uh          , Rd          , Qxu         , Uu^Uf       , Re          , Uh          , Re          , Gs^Fp       , Gg          , Ch          , Ch          , 5 Kh        , Rp          , Rp          , Gs^Fms      , Gg          , Mm          , Ww          , Ww          , Gs^Fms      , Hh          , Gs^Fp       , Gg          , Rd          , Hh          , Rd          , Gs^Fp       , Hh          , Hh          
Uu^Uf       , Uu^Uf       , Uu^Vu       , Rd          , Uu^Uf       , Xu          , Xu          , Xu          , Uu^Vud      , Rd          , Xu          , Xu          , Gs^Fms      , Ch          , Ch          , Gg          , Gg          , Rp          , Wwf         , Ww          , Gg          , Gs^Fds      , Hh          , Mm          , Hh          , Rd          , Gs^Fp       , Rd          , Gg          , Gg^Ve       , Hh          , Hh          
Uu          , Uu          , Uh          , Rd          , Rd          , Uu          , Rd          , Uu^Uf       , Rd          , Rd          , Uu^Uf       , Xu          , Gs^Fp       , Gs^Fds      , Wwf         , Wwf         , Wwf         , Wwf         , Rd          , Gg          , Rd          , Gg^Vh       , Rd          , Gg          , Rd          , Rd          , Gg          , Gg          , Hh          , Gg          , Gs^Fp       , Gs^Fp       
Qxu         , Qxu         , Qxu         , Uu          , Uh          , Rd          , Uh          , Rd          , Uh          , Uu          , Qxu         , Qxu         , Hh          , Hh          , Wwf         , Gs^Fp       , Mm          , Gg          , Gs^Fp       , Rd          , Gs^Fp       , Rd          , Gs^Fms      , Rd          , Hh          , Gs^Fp       , Gg          , Mm          , Hh^Uf       , Gs^Fms      , Gs^Fds      , Gs^Fp       
Qxu         , Qxu         , Qxu         , Uu          , Uh          , Rd          , Uh          , Rd          , Uh          , Uu          , Qxu         , Qxu         , Hh          , Hh          , Wwf         , Gs^Fp       , Mm          , Gg^Uf       , Gs^Fp       , Rd          , Gg          , Gs^Fds      , Gg          , Rd          , Hh          , Gg^Uf       , Hh          , Mm          , Hh          , Gs^Fp       , Gs^Fp       , Gs^Fp       
