border_size=1
usage=map

_off^_usr   , _off^_usr   , _off^_usr   , _off^_usr   , _off^_usr   , _off^_usr   , _off^_usr   , _off^_usr   , _off^_usr   , _off^_usr   , _off^_usr   , _off^_usr   , _off^_usr   , _off^_usr   , _off^_usr   , _off^_usr   , _off^_usr   , _off^_usr   , _off^_usr   , _off^_usr   , _off^_usr   , _off^_usr   , _off^_usr   , _off^_usr   , _off^_usr   , _off^_usr   , _off^_usr   , _off^_usr   , _off^_usr   , _off^_usr   , _off^_usr   , _off^_usr   , _off^_usr   
_off^_usr   , _off^_usr   , _off^_usr   , _off^_usr   , _off^_usr   , _off^_usr   , _off^_usr   , _off^_usr   , _off^_usr   , _off^_usr   , _off^_usr   , _off^_usr   , _off^_usr   , _off^_usr   , _off^_usr   , _off^_usr   , _off^_usr   , _off^_usr   , _off^_usr   , _off^_usr   , _off^_usr   , _off^_usr   , _off^_usr   , _off^_usr   , _off^_usr   , _off^_usr   , _off^_usr   , _off^_usr   , _off^_usr   , _off^_usr   , _off^_usr   , _off^_usr   , _off^_usr   
_off^_usr   , _off^_usr   , _off^_usr   , _off^_usr   , _off^_usr   , _off^_usr   , _off^_usr   , _off^_usr   , _off^_usr   , _off^_usr   , _off^_usr   , _off^_usr   , _off^_usr   , _off^_usr   , _off^_usr   , _off^_usr   , _off^_usr   , _off^_usr   , _off^_usr   , _off^_usr   , _off^_usr   , _off^_usr   , _off^_usr   , _off^_usr   , _off^_usr   , _off^_usr   , _off^_usr   , _off^_usr   , _off^_usr   , _off^_usr   , _off^_usr   , _off^_usr   , _off^_usr   
_off^_usr   , _off^_usr   , _off^_usr   , _off^_usr   , _off^_usr   , _off^_usr   , _off^_usr   , _off^_usr   , _off^_usr   , _off^_usr   , _off^_usr   , _off^_usr   , _off^_usr   , _off^_usr   , Hh          , Gg^Fet      , 6 Ke        , Hh          , Gs^Fp       , _off^_usr   , _off^_usr   , _off^_usr   , _off^_usr   , _off^_usr   , _off^_usr   , _off^_usr   , _off^_usr   , _off^_usr   , _off^_usr   , _off^_usr   , _off^_usr   , _off^_usr   , _off^_usr   
_off^_usr   , _off^_usr   , _off^_usr   , _off^_usr   , _off^_usr   , _off^_usr   , _off^_usr   , _off^_usr   , _off^_usr   , _off^_usr   , _off^_usr   , _off^_usr   , Dd^Vda      , Rd          , Rd          , Ce          , Ce          , Ce          , Rp          , Rp          , Gs^Vl       , _off^_usr   , _off^_usr   , _off^_usr   , _off^_usr   , _off^_usr   , _off^_usr   , _off^_usr   , _off^_usr   , _off^_usr   , _off^_usr   , _off^_usr   , _off^_usr   
_off^_usr   , _off^_usr   , _off^_usr   , _off^_usr   , _off^_usr   , _off^_usr   , _off^_usr   , _off^_usr   , _off^_usr   , _off^_usr   , Md          , Rd          , Gs^Ft       , Ds          , Gs          , Gll         , Gs          , Rp          , Gs^Wm       , Gd          , Hh          , Gs          , Ds          , _off^_usr   , _off^_usr   , _off^_usr   , _off^_usr   , _off^_usr   , _off^_usr   , _off^_usr   , _off^_usr   , _off^_usr   , _off^_usr   
_off^_usr   , _off^_usr   , _off^_usr   , _off^_usr   , _off^_usr   , _off^_usr   , _off^_usr   , _off^_usr   , Md          , Md          , Dd          , Dd          , Gs          , Hh          , Gll         , Gll         , Gll         , Rp          , Rp          , Gg          , Hh          , Gg^Fet      , Mm          , Dd          , Ds          , _off^_usr   , _off^_usr   , _off^_usr   , _off^_usr   , _off^_usr   , _off^_usr   , _off^_usr   , _off^_usr   
_off^_usr   , _off^_usr   , _off^_usr   , _off^_usr   , _off^_usr   , _off^_usr   , Dd^Vda      , Rd          , Dd          , Dd          , Hh          , Gs          , Gll         , Gll         , Hh          , Gs          , Gll         , Gg^Fet      , Gg^Vl       , Rp          , Rp          , Gs^Fp       , Hh          , Gg^Fet      , Hh          , Gs          , Gg^Vl       , _off^_usr   , _off^_usr   , _off^_usr   , _off^_usr   , _off^_usr   , _off^_usr   
_off^_usr   , _off^_usr   , _off^_usr   , _off^_usr   , Gs^Ft       , Rd          , Ds          , Hd          , Gs          , Gs^Ft       , Gll         , Gll         , Gs          , Gs^Fds      , Gs^Vl       , Gs          , Gll         , Hh          , Gs^Fms      , Gg^Efm      , Gll         , Rp          , Rp          , Gs^Fp       , Gs          , Gd          , Gs          , Hh          , Ww          , _off^_usr   , _off^_usr   , _off^_usr   , _off^_usr   
_off^_usr   , _off^_usr   , _off^_usr   , Hh          , Ce          , Rd          , Gs          , Gs^Ft       , Gll         , Gll         , Gs          , Gs          , Gs^Fds      , Gs          , Wwf         , Gs          , Gll         , Gll         , Gll         , Gll         , Hh          , Gs^Fp       , Hh          , Rp          , Rp          , Gg          , Gs^Fp       , Wwf         , Ce          , Gg^Fet      , _off^_usr   , _off^_usr   , _off^_usr   
_off^_usr   , _off^_usr   , Gg^Fet      , 2 Ke        , Ce          , Gll         , Gll         , Gll         , Hh          , Gs          , Gs          , Hh          , Wwf         , Wwf         , Ww          , Hh          , Gll         , Gs^Fms      , Gd          , Gll         , Gll         , Gs^Fp       , Gll         , Gll         , Gg^Vl       , Rp          , Rp          , Wwf         , Ce          , 3 Ke        , Hh          , _off^_usr   , _off^_usr   
_off^_usr   , _off^_usr   , Hh          , Ce          , Gll         , Gll         , Gll         , Gs          , Gs^Fds      , Gs^Vl       , Gs          , Wwf         , Ww          , Ww          , Gs          , Gs^Fds      , Gll         , Hh          , Gll         , Gll         , Gs^Fp       , Gll         , Gll         , Gg          , Gg          , Hh          , Rp          , Ww^Bw/      , Ds          , Ce          , Gs^Fms      , _off^_usr   , _off^_usr   
_off^_usr   , _off^_usr   , Gll         , Gll         , Gs          , Gll         , Gg          , Gll         , Gll         , Gll         , Hh          , Gs^Fds      , Ww          , Ss^Vhs      , Gll         , Gll         , Gll         , Gll         , Gs          , Gg^Vl       , Hh          , Gs          , Ss          , Chs         , Rp          , Rp          , Gg          , Wwf         , Ds          , Ds          , Ss^Ft       , _off^_usr   , _off^_usr   
_off^_usr   , _off^_usr   , Gd^Vht      , Ss          , Gd          , Gll         , Hh          , Gs^Fms      , Gll         , Gll         , Gll         , Wwf         , Wwf         , Wwf         , Gs          , Gs          , Cud         , Gs          , Gd          , Gs^Fms      , Mm          , Gg          , Rp          , Rp          , Gll         , Hh          , Gg^Vl       , Wwf         , Ww          , Ss^Vhs      , Ss^Uf       , _off^_usr   , _off^_usr   
_off^_usr   , _off^_usr   , Gd          , Ss          , Gs          , Gll         , Gg          , Gg^Vl       , Gll         , Hh          , Gs          , Gll         , Gll         , Gs          , Cud         , 7 Kud       , Xu          , Cud         , Xu          , Xu          , Wwf         , Rp          , Wwf         , Gs^Fp       , Ww^Bw|      , Gs^Fp       , Wwf         , Wwf         , Gll         , Ss          , Wwf         , _off^_usr   , _off^_usr   
_off^_usr   , _off^_usr   , Ss^Uf       , Ss          , Hh          , Gll         , Gs^Fms      , Gg          , Gll         , Gs^Fms      , Gd          , Gll         , Gs          , Cud         , Xu          , Xu          , Ur          , Xu          , Ww          , Wwf         , Gs^Fet      , Wwf         , Hh          , Wwf         , Chw         , Wwf         , Gg          , Gll         , Gg          , Ss          , Ss^Uf       , _off^_usr   , _off^_usr   
_off^_usr   , _off^_usr   , Ss          , Ss          , Ss^Fp       , Gll         , Hh          , Gg          , Gll         , Gs          , Gg^Vl       , Gll         , Gd          , Gll^Vl      , Xu          , Wwr         , Ww^Vm       , Ww          , Xu          , Hhd         , Gd          , Gll         , Gg^Vl       , Gg          , Gll         , Gg          , Hh          , Gll         , Ss^Fp       , Ss          , Wwf         , _off^_usr   , _off^_usr   
_off^_usr   , _off^_usr   , Ss^Uf       , Ss          , Gg          , Gll         , Gg          , Gg          , Chw         , Gg          , Hh          , Gll         , Gs^Fet      , Hhd         , Ww          , Ww          , Ur          , Wwr         , Xu          , Gll^Vl      , Gs          , Gll         , Gg          , Gg          , Gll         , Gg          , Gs^Fms      , Gll         , Hh          , Ss          , Ss^Uf       , _off^_usr   , _off^_usr   
_off^_usr   , _off^_usr   , Ss^Ii       , Ss          , Gg          , Gll         , Wwf         , Wwf         , Ww^Bw|      , Wwf         , Wwf         , Wwf         , Wwf         , Wwf         , Xu          , Xu          , Xu          , Xu          , Cud         , Cud         , Gll         , Gll         , Gs          , Gs^Fms      , Gll         , Gg          , Gs          , Gll         , Gg          , Ss          , Gd          , _off^_usr   , _off^_usr   
_off^_usr   , _off^_usr   , Ss^Uf       , Ss          , Ww          , Wwf         , Gg^Vl       , Gs^Fp       , Gll         , Gs^Fp       , Rp          , Rp          , Mm          , Xu          , Gg          , Cud         , Cud         , 8 Kud       , Gs          , Gs          , Wwf         , Gll         , Gll         , Hh          , Gll         , Gg^Vl       , Hh          , Gll         , Gg          , Ss          , Gd^Vht      , _off^_usr   , _off^_usr   
_off^_usr   , _off^_usr   , Ss^Ft       , Ss^Vhs      , Ds          , Wwf         , Gg          , Hh          , Rp          , Rp          , Ss          , Gg^Efm      , Hh          , Gs^Fms      , Gg          , Gg          , Gll         , Gs          , Gll         , Wwf         , Ww          , Wwf         , Hh          , Gll         , Gll         , Gs^Fms      , Gg          , Gll         , Gg          , Ss          , Gll         , _off^_usr   , _off^_usr   
_off^_usr   , _off^_usr   , Gs^Fms      , Ds          , Ds          , Wwf         , Rp          , Rp          , Gg          , Chs         , Gll         , Gg^Efm      , Gs^Fp       , Gg^Vl       , Gll         , Gll         , Gll         , Gll         , Gs          , Ss^Vhs      , Ww          , Gs^Fds      , Gs          , Gll         , Gs^Fds      , Gll         , Gll         , Gll         , Gll         , Gll         , Hh          , _off^_usr   , _off^_usr   
_off^_usr   , _off^_usr   , Hh          , Ce          , Ce          , Ww^Bw/      , Rp          , Hh          , Gg^Vl       , Gg          , Gll         , Gll         , Gll         , Gll         , Gg^Efm      , Hh          , Gll         , Gs^Fds      , Ww          , Ww          , Wwf         , Wwf         , Gd          , Gs^Vl       , Hh          , Gs          , Gll         , Gll         , Ce          , Ce          , Gg^Fet      , _off^_usr   , _off^_usr   
_off^_usr   , _off^_usr   , _off^_usr   , 4 Ke        , Ce          , Wwf         , Gs^Fp       , Rp          , Rp          , Gll         , Hh          , Gs^Fp       , Hh          , Gll         , Gll         , Gs^Fms      , Gll         , Hh          , Wwf         , Wwf         , Gs^Fds      , Hh          , Gs          , Gs          , Gll         , Gll         , Gs          , Gll         , Ce          , 1 Ke        , _off^_usr   , _off^_usr   , _off^_usr   
_off^_usr   , _off^_usr   , _off^_usr   , Gg^Fet      , Ww          , Wwf         , Gs          , Gg          , Gs          , Rp          , Rp          , Gs^Fp       , Gll         , Gll         , Gg^Fet      , Gll         , Gll         , Gs          , Gs^Vl       , Gs          , Gs          , Gs          , Gll         , Gll         , Gs          , Gs^Ft       , Ds          , Rd          , Gs^Ft       , Hh          , _off^_usr   , _off^_usr   , _off^_usr   
_off^_usr   , _off^_usr   , _off^_usr   , _off^_usr   , _off^_usr   , Hh          , Gg^Vl       , Gd          , Hh          , Gs^Fp       , Hh          , Rp          , Rp          , Gg          , Gg^Vl       , Hh          , Gll         , Gs          , Gs^Fms      , Hh          , Gll         , Gll         , Hh          , Gs^Ft       , Dd          , Hd          , Dd^Vda      , Rd          , _off^_usr   , _off^_usr   , _off^_usr   , _off^_usr   , _off^_usr   
_off^_usr   , _off^_usr   , _off^_usr   , _off^_usr   , _off^_usr   , _off^_usr   , _off^_usr   , Gs          , Ds          , Gg^Fet      , Mm          , Gs^Fp       , Hh          , Rp          , Rp          , Gs^Fms      , Gll         , Gs          , Gll         , Gll         , Hh          , Gs          , Dd          , Dd          , Md          , Rd          , _off^_usr   , _off^_usr   , _off^_usr   , _off^_usr   , _off^_usr   , _off^_usr   , _off^_usr   
_off^_usr   , _off^_usr   , _off^_usr   , _off^_usr   , _off^_usr   , _off^_usr   , _off^_usr   , _off^_usr   , _off^_usr   , Dd          , Ds          , Gg^Fet      , Hh          , Gg          , Gs^Wm       , Rp          , Gs          , Gll         , Gs          , Gs          , Gs^Ft       , Dd          , Md          , Md          , _off^_usr   , _off^_usr   , _off^_usr   , _off^_usr   , _off^_usr   , _off^_usr   , _off^_usr   , _off^_usr   , _off^_usr   
_off^_usr   , _off^_usr   , _off^_usr   , _off^_usr   , _off^_usr   , _off^_usr   , _off^_usr   , _off^_usr   , _off^_usr   , _off^_usr   , _off^_usr   , Gs          , Gg^Vl       , Gs          , Rp          , Rp          , Ce          , Gll         , Rd          , Ds          , Dd^Vda      , Rd          , _off^_usr   , _off^_usr   , _off^_usr   , _off^_usr   , _off^_usr   , _off^_usr   , _off^_usr   , _off^_usr   , _off^_usr   , _off^_usr   , _off^_usr   
_off^_usr   , _off^_usr   , _off^_usr   , _off^_usr   , _off^_usr   , _off^_usr   , _off^_usr   , _off^_usr   , _off^_usr   , _off^_usr   , _off^_usr   , _off^_usr   , _off^_usr   , Rp          , Gg^Fet      , Ce          , 5 Ke        , Ce          , Hh          , Rd          , _off^_usr   , _off^_usr   , _off^_usr   , _off^_usr   , _off^_usr   , _off^_usr   , _off^_usr   , _off^_usr   , _off^_usr   , _off^_usr   , _off^_usr   , _off^_usr   , _off^_usr   
_off^_usr   , _off^_usr   , _off^_usr   , _off^_usr   , _off^_usr   , _off^_usr   , _off^_usr   , _off^_usr   , _off^_usr   , _off^_usr   , _off^_usr   , _off^_usr   , _off^_usr   , _off^_usr   , _off^_usr   , Hh          , _off^_usr   , Gs^Fp       , _off^_usr   , _off^_usr   , _off^_usr   , _off^_usr   , _off^_usr   , _off^_usr   , _off^_usr   , _off^_usr   , _off^_usr   , _off^_usr   , _off^_usr   , _off^_usr   , _off^_usr   , _off^_usr   , _off^_usr   
_off^_usr   , _off^_usr   , _off^_usr   , _off^_usr   , _off^_usr   , _off^_usr   , _off^_usr   , _off^_usr   , _off^_usr   , _off^_usr   , _off^_usr   , _off^_usr   , _off^_usr   , _off^_usr   , _off^_usr   , _off^_usr   , _off^_usr   , _off^_usr   , _off^_usr   , _off^_usr   , _off^_usr   , _off^_usr   , _off^_usr   , _off^_usr   , _off^_usr   , _off^_usr   , _off^_usr   , _off^_usr   , _off^_usr   , _off^_usr   , _off^_usr   , _off^_usr   , _off^_usr   
_off^_usr   , _off^_usr   , _off^_usr   , _off^_usr   , _off^_usr   , _off^_usr   , _off^_usr   , _off^_usr   , _off^_usr   , _off^_usr   , _off^_usr   , _off^_usr   , _off^_usr   , _off^_usr   , _off^_usr   , _off^_usr   , _off^_usr   , _off^_usr   , _off^_usr   , _off^_usr   , _off^_usr   , _off^_usr   , _off^_usr   , _off^_usr   , _off^_usr   , _off^_usr   , _off^_usr   , _off^_usr   , _off^_usr   , _off^_usr   , _off^_usr   , _off^_usr   , _off^_usr   
