border_size=1
usage=map

_off^_usr   , _off^_usr   , _off^_usr   , _off^_usr   , _off^_usr   , _off^_usr   , _off^_usr   , _off^_usr   , _off^_usr   , _off^_usr   , _off^_usr   , _off^_usr   , _off^_usr   , _off^_usr   , _off^_usr   , _off^_usr   , _off^_usr   , _off^_usr   , _off^_usr   , _off^_usr   , _off^_usr   , _off^_usr   
_off^_usr   , _off^_usr   , _off^_usr   , _off^_usr   , _off^_usr   , _off^_usr   , _off^_usr   , _off^_usr   , _off^_usr   , _off^_usr   , _off^_usr   , _off^_usr   , _off^_usr   , _off^_usr   , _off^_usr   , _off^_usr   , _off^_usr   , _off^_usr   , _off^_usr   , _off^_usr   , _off^_usr   , _off^_usr   
_off^_usr   , _off^_usr   , _off^_usr   , _off^_usr   , _off^_usr   , _off^_usr   , _off^_usr   , _off^_usr   , _off^_usr   , _off^_usr   , _off^_usr   , _off^_usr   , _off^_usr   , _off^_usr   , _off^_usr   , _off^_usr   , _off^_usr   , _off^_usr   , _off^_usr   , _off^_usr   , _off^_usr   , _off^_usr   
_off^_usr   , _off^_usr   , _off^_usr   , _off^_usr   , _off^_usr   , _off^_usr   , _off^_usr   , _off^_usr   , _off^_usr   , _off^_usr   , _off^_usr   , _off^_usr   , _off^_usr   , _off^_usr   , _off^_usr   , _off^_usr   , _off^_usr   , _off^_usr   , _off^_usr   , _off^_usr   , _off^_usr   , _off^_usr   
_off^_usr   , _off^_usr   , _off^_usr   , _off^_usr   , _off^_usr   , _off^_usr   , _off^_usr   , _off^_usr   , _off^_usr   , _off^_usr   , _off^_usr   , _off^_usr   , _off^_usr   , _off^_usr   , _off^_usr   , _off^_usr   , _off^_usr   , _off^_usr   , _off^_usr   , _off^_usr   , _off^_usr   , _off^_usr   
_off^_usr   , _off^_usr   , _off^_usr   , _off^_usr   , _off^_usr   , _off^_usr   , _off^_usr   , _off^_usr   , _off^_usr   , _off^_usr   , _off^_usr   , _off^_usr   , _off^_usr   , _off^_usr   , _off^_usr   , _off^_usr   , _off^_usr   , _off^_usr   , _off^_usr   , _off^_usr   , _off^_usr   , _off^_usr   
_off^_usr   , _off^_usr   , _off^_usr   , _off^_usr   , _off^_usr   , _off^_usr   , _off^_usr   , _off^_usr   , _off^_usr   , _off^_usr   , _off^_usr   , _off^_usr   , _off^_usr   , _off^_usr   , _off^_usr   , _off^_usr   , _off^_usr   , _off^_usr   , _off^_usr   , _off^_usr   , Ai          , _off^_usr   
_off^_usr   , Xv          , Xv          , Xv          , Xv          , Xv          , Xv          , Xv          , Xv          , Xv          , Xv          , Xv          , Xv          , Xv          , Xv          , Xv          , Xv          , _off^_usr   , Ai          , _off^_usr   , Ai          , _off^_usr   
_off^_usr   , Ww^Vm       , Ww          , Gs^Fp       , Mm          , Hh          , Gs^Fp       , Re          , Gs^Fp       , Ss          , Ss          , Ss          , Ss          , Ds          , Ds          , Ss          , Mm^Xm       , Xu          , Xu          , Ai          , Ai          , _off^_usr   
_off^_usr   , Ww          , Ww          , Mm          , Mm          , Mm          , Re          , Re          , Gg          , Ss^Vhs      , Gs^Fp       , Gs^Fp       , Ds          , Ds          , Re^Uf       , Ss          , Mm^Xm       , Xu          , Cud         , Xu          , Ai          , _off^_usr   
_off^_usr   , Mm          , Gs^Fp       , Ww          , Ww          , Gg          , Gg          , Re          , Gg          , Hh          , Gs^Fp       , Hh          , Gg          , Gg^Vh       , Gg          , Re^Uf       , Mm^Xm       , Xu          , Cud         , Xu          , Ai          , _off^_usr   
_off^_usr   , Hh          , Gs          , Gs^Ft       , Gs          , Wwf         , Wwf         , Gg          , Gg          , Hh          , Gg          , Gg          , Gg          , Gg          , Re          , Re          , Mm^Xm       , Xu          , Cud         , Xu          , Ai          , _off^_usr   
_off^_usr   , Gs^Vht      , Re          , Gs          , Gs^Ft       , Gs          , Ss^Vhs      , Ds          , Hh          , Gg          , Gg          , Gg          , Re          , Re          , Ch          , Ch          , Mm^Xm       , Xu          , Cud         , Xu          , Ai          , _off^_usr   
_off^_usr   , Re          , Re          , Re          , Gs^Ft       , Ds          , Ss          , Wwf         , Gg          , Gg          , Re          , Re          , Ch          , Ch          , Re^Gvs      , Ch          , Mm^Xm       , Xu          , Cud         , Xu          , Ai          , _off^_usr   
_off^_usr   , Gg          , Hh          , Re          , Re          , Hh          , Gs^Fp       , Wwf         , Gg          , Gg          , Re          , Ch          , Gg^Efm      , Re^Gvs      , Gg          , 4 Kh        , Mm^Xm       , Xu          , Cud         , Xu          , Ai          , _off^_usr   
_off^_usr   , Gg          , Gg^Vh       , Re^Uf       , Re          , Gg          , Gg          , Gg          , Ww          , Gg          , Re          , Gg^Ve       , Re^Gvs      , Gg          , Re^Gvs      , Gg^Vh       , Mm^Xm       , Xu          , Cud         , Xu          , Ai          , _off^_usr   
_off^_usr   , Gg          , Gs^Fp       , Hh          , Re          , Re          , Gg          , Mm          , Ww          , Gg          , Re          , Ch          , Ch          , Re^Gvs      , Gg^Efm      , 3 Kh        , Mm^Xm       , Xu          , Cud         , Xu          , Ai          , _off^_usr   
_off^_usr   , Gg          , Gg          , Gg          , Mm          , Re          , Gg          , Ds          , Ww          , Gs^Fp       , Gg          , Re          , Re          , Ch          , Ch          , Ch          , Mm^Xm       , Xu          , Cud         , Xu          , Ai          , _off^_usr   
_off^_usr   , Gg          , Gg          , Gs^Fp       , Hh          , Re          , Gg^Ve       , Gs^Fp       , Mm          , Ww          , Gg          , Gg          , Gs^Fp       , Re          , Re          , Ch          , Mm^Xm       , Xu          , Cud         , Xu          , Ai          , _off^_usr   
_off^_usr   , Gg          , Gs^Ft       , Gg          , Gg          , Re          , Re          , Gg          , Gs^Fp       , Ww          , Gg          , Gs^Fp       , Gg          , Gg          , Gg          , Re          , Mm^Xm       , Xu          , Cud         , Xu          , Ai          , _off^_usr   
_off^_usr   , Gs^Ft       , Hd          , Dd          , Dd          , Gg          , Gg          , Re          , Ss^Bw\      , Ss          , Gg          , Gg          , Hh          , Gg          , Gg          , Hh          , Mm^Xm       , Xu          , Cud         , Xu          , Ai          , _off^_usr   
_off^_usr   , Dd          , Md          , Dd^Do       , Dd          , Dd          , Dd          , Gs^Ft       , Ss          , Re          , Gg          , Mm          , Ww          , Wwf         , Gg          , Hh          , Mm^Xm       , Xu          , Xu          , Xu          , Ai          , _off^_usr   
_off^_usr   , Md          , Dd^Dc       , Hd          , Dd          , Dd^Vda      , Gs^Ft       , Hh          , Ss          , Re          , Re          , Mm          , Ww          , Gg^Ve       , Gs^Fp       , Gg^Fet      , Mm^Xm       , Xu          , Ai          , Ai          , Ai          , _off^_usr   
_off^_usr   , _off^_usr   , _off^_usr   , _off^_usr   , _off^_usr   , _off^_usr   , _off^_usr   , _off^_usr   , _off^_usr   , _off^_usr   , _off^_usr   , _off^_usr   , _off^_usr   , _off^_usr   , _off^_usr   , _off^_usr   , _off^_usr   , _off^_usr   , _off^_usr   , _off^_usr   , _off^_usr   , _off^_usr   
