border_size=1
usage=map

Ds          , Ds          , Ds          , Ds          , Ds          , Ds          , Ds          , Ds          , Ds          , Ds          , Ds          , Ds          , Ds          , Ds          , Md          , Md          , Md          , Md          , Md          , Md          , Wwg         , Md          , Wwg         , Wwg         , Md          , Md          , Md          , Md          , Md          , Md          , Md          , Gll^Fp      , Gll^Fp      , Gll^Fp      , Md          , Md          , Md          , Md          , Md          , Md          , Md          , Gll^Fdw     , Gll^Fdw     , Gll^Fdw     , Gll^Fdw     , Gll         , Gll         , Gll         , Gll         , Gll         , Gll         , Gll         , Gll^Fdw     , Gll^Fdw     
Ds          , Ds          , Ds          , Ds          , Ds          , Ds          , Ds          , Ds          , Ds          , Ds          , Ds          , Ds          , Ds          , Md          , Md          , Md          , Md          , Md          , Wwg         , Wwg         , Md          , Md          , Md          , Md          , Md          , Md          , Md          , Md          , Md          , Md          , Md          , Md          , Gll^Fp      , Gll^Fp      , Gll^Fp      , Gll^Fp      , Gll^Fp      , Md          , Md          , Md          , Md          , Md          , Ea          , Gll^Fdw     , Gll         , Gll         , Gll         , Gll         , Gll         , Gll         , Gll         , Gll         , Gll         , Gll^Fdw     
Ds          , Ds          , Ds          , Ds          , Ds          , Ds          , Ds          , Ds          , Ds          , Ds          , Ds          , Ds          , Md          , Md          , Md          , Md          , Md          , Wwg         , Md          , Md          , Md          , Md          , Md          , Md          , Md          , Md          , Md          , Md          , Md          , Md          , Md          , Md          , Md          , Gll^Fp      , Gll^Fp      , Gll^Fp      , Gll^Fp      , Gll^Fp      , Md          , Md          , Md          , Md          , Md          , Gll         , Gll         , Gll         , Gll         , Gll         , Gll         , Gll         , Gll         , Gll         , Gll         , Gll^Fdw     
Ds          , Ds          , Ds          , Ds          , Ds          , Ds          , Ds          , Ds          , Ds          , Ds          , Ds          , Ds          , Md          , Md          , Md          , Md          , Md          , Wwg         , Md          , Md          , Md          , Md          , Md          , Gll^Ftr     , Gll^Ftr     , Md          , Gll^Ftr     , Md          , Ea          , Md          , Md          , Md          , Md          , Md          , Gll^Fp      , Gll^Fp      , Gll^Fp      , Gll^Fp      , Gll^Fp      , Md          , Md          , Md          , Md          , Wwf         , Gll         , Gll         , Gll         , Gll         , Rrc         , Gll         , Gll         , Gll         , Gll         , Gll         
Ds          , Ds          , Ds          , Ds          , Ds          , Ds          , Ds          , Ds          , Ds          , Ds          , Wwg         , Md          , Md          , Md          , Md          , Md          , Md          , Wwg         , Wwg         , Md          , Md          , Md          , Gll^Ftr     , Gll^Ftr     , Gll^Ftr     , Gll^Ftr     , Gll^Ftr     , Gll^Ftr     , Gll^Ftr     , Gll^Ftr     , Gll^Ftr     , Md          , Md          , Md          , Md          , Gll^Fp      , Gll^Fp      , Gll^Fp      , Gll^Fmw     , Md          , Md          , Md          , Gll^Fmw     , Wwf         , Wwf         , Gll         , Rp          , Gll         , Gll         , Gll         , Gll         , Gll         , Gll         , Gll         
Ds          , Ds          , Ds          , Ds          , Ds          , Ds          , Ds          , Ds          , Ds          , Ds          , Ds          , Wwg         , Wwg         , Md          , Md          , Md          , Md          , Md          , Md          , Wwg         , Md          , Md          , Gll^Ftr     , Gll^Ftr     , Gll^Ftr     , Gll^Ftr     , Gll^Ftr     , Rrc         , Rrc         , Rrc         , Rrc         , Rrc         , Rrc         , Rrc         , Rrc         , Md          , Md          , Gll^Fmw     , Gll^Fmw     , Gll^Fmw     , Gll^Fmw     , Gll^Fmw     , Rp          , Gll^Fmw     , Rp          , Rp          , Gll         , Gll         , Gll         , Gll         , Gll         , Gll         , Gll         , Gll         
Ds          , Ds          , Ds          , Ds          , Ds          , Ds          , Ds          , Ds          , Ds          , Ds          , Ds          , Ds          , Md          , Wwg         , Md          , Md          , Md          , Md          , Wwg         , Wwg         , Md          , Md          , Gll^Ftr     , Gll^Ftr     , Gll^Ftr     , Gll^Ftr     , Gll^Ftr     , Rrc         , Rrc         , Rrc         , Rrc         , Rrc         , Rrc         , Rrc         , Rrc         , Md          , Gll^Ftr     , Md          , Gll^Fmw     , Gll^Fmw     , Rp          , Rp          , Gll^Fmw     , Rp          , Md          , Gll         , Wwf         , Gll         , Wwf         , Gll         , Gll         , Gll         , Gll         , Gll         
Ds          , Ds          , Ds          , Ds          , Ds          , Ds          , Ds          , Ds          , Ds          , Ds          , Ds          , Ea          , Md          , Wwg         , Wwg         , Md          , Wwg         , Wwg         , Wwg         , Wwg         , Md          , Md          , Gll^Ftr     , Gll^Ftr     , Gll^Ftr     , Gll^Ftr     , Gll^Ftr     , Rrc         , Rrc         , Rrc         , Rp          , Rrc         , Rrc         , Rrc         , Rrc         , Gll^Ftr     , Gll^Ftr     , Gll^Ftr     , Rp          , Rp          , Gll^Fmw     , Gll^Fmw     , Gll^Fmw     , Md          , Md          , Md          , Md          , Wwf         , Md          , Wwf         , Wwf         , Ea          , Wwf         , Gll         
Ds          , Ds          , Ds          , Ds          , Rr          , Ds          , Ds          , Ds          , Ds          , Ds          , Md          , Md          , Md          , Md          , Md          , Wwg         , Md          , Md          , Md          , Md          , Md          , Md          , Md          , Gll^Ftr     , Md          , Ea          , Gll^Ftr     , Rrc         , Rrc         , Rrc         , Rrc         , Rrc         , Rrc         , Rrc         , Rrc         , Rp          , Rp          , Rp          , Gll^Ftr     , Gll^Fmw     , Gll^Fmw     , Gll^Fmw     , Md          , Md          , Md          , Md          , Md          , Md          , Md          , Md          , Md          , Wwf         , Md          , Wwf         
Ds          , Ds          , Ds          , Ds          , Ds          , Ds          , Ds          , Ds          , Ds          , Ds          , Md          , Md          , Md          , Md          , Md          , Md          , Md          , Md          , Md          , Md          , Gll^Ftr     , Gll^Ftr     , Gll^Ftr     , Md          , Md          , Md          , Gll^Ftr     , Rrc         , Rrc         , Rrc         , Rrc         , Rrc         , Rrc         , Rrc         , Rrc         , Gll^Ftr     , Gll^Ftr     , Gll^Ftr     , Md          , Md          , Md          , Md          , Md          , Md          , Md          , Md          , Md          , Md          , Md          , Md          , Md          , Md          , Md          , Md          
Ds          , Ds          , Ds          , Ds          , Ds          , Ds          , Ds          , Ds          , Ds          , Ds          , Cd          , Md          , Md          , Md          , Md          , Md          , Md          , Md          , Wwt         , Gll^Ftr     , Gll^Ftr     , Md          , Gll^Ftr     , Gll^Ftr     , Md          , Md          , Gll^Ftr     , Rrc         , Rrc         , Rrc         , Md          , Rrc         , Md          , Rrc         , Gll^Ftr     , Wwf         , Wwf         , Md          , Wwf         , Md          , Ss          , Md          , Md          , Md          , Md          , Md          , Md          , Md          , Md          , Md          , Md          , Md          , Md          , Md          
Ds          , Ds          , Ds          , Ds          , Ds          , Ds          , Ds          , Ds          , Cd          , Cd          , Wwg         , Wwg         , Wwg         , Mm          , Hd          , Md          , Md          , Md          , Wwt         , Wwt         , Wwt         , Gll^Ftr     , Gll^Ftr     , Gll^Ftr     , Gll^Ftr     , Gll^Ftr     , Gll^Ftr     , Md          , Md          , Md          , Md          , Md          , Md          , Md          , Wwf         , Wwf         , Wwf         , Wwf         , Ss          , Ss          , Ss          , Ss          , Gs^Fms      , Md          , Md          , Md          , Md          , Md          , Md          , Md          , Md          , Md          , Md          , Md          
Ds          , Ds          , Ds          , Ds          , Ds          , Ds          , Dd^Ftd      , Ds          , Cd          , Wwg         , Wwg         , Dd^Do       , Wwg         , Hd          , Hd          , Hd          , Hd          , Wwt         , Wwt         , Wwt         , Wwt         , Wwt         , Gll^Ftr     , Gll^Ftr     , Gll^Ftr     , Gll^Ftr     , Gll^Ftr     , Gll^Ftr     , Gll^Ftr     , Md          , Md          , Md          , Md          , Md          , Wwf         , Wwf         , Ss          , Ss          , Ss          , Ss          , Ss          , Ss          , Gs^Fms      , Gs^Fms      , Gs^Fms      , Md          , Md          , Md          , Md          , Md          , Md          , Md          , Md          , Md          
Md          , Md          , Md          , Ds          , Ea          , Dd^Ftd      , Dd^Ftd      , Dd^Ftd      , Hh          , Wwg         , Wwg         , Wwg         , Hd          , Hd          , Md          , Hd          , Md          , Ds          , Wwt         , Wwt         , Md          , Md          , Md          , Gll^Ftr     , Gll^Ftr     , Gll^Ftr     , Gll^Ftr     , Gll^Ftr     , Gll^Ftr     , Gll^Ftr     , Gll^Ftr     , Gll^Ftr     , Md          , Md          , Wwf         , Wwf         , Ss          , Ss          , Ss          , Ss          , Ss          , Ss          , Gs^Fms      , Gs^Fms      , Gs^Fms      , Gs^Fms      , Gs^Fms      , Md          , Ea          , Md          , Gs^Fms      , Md          , Gs^Fms      , Gs^Fms      
Md          , Md          , Md          , Md          , Md          , Md          , Md          , Hh          , Hh          , Hh          , Hh          , Hd          , Md          , Md          , Md          , Md          , Md          , Ds          , Wwt         , Wwt         , Wwt         , Md          , Md          , Md          , Md          , Md          , Md          , Gll^Ftr     , Wwt         , Gll^Ftr     , Wwt         , Wwt         , Wwt         , Md          , Ss          , Ss          , Ss          , Ss          , Ss          , Ss          , Gll         , Gll         , Gll         , Gll^Fdw     , Gll^Fdw     , Gs^Fms      , Gs^Fms      , Gs^Fms      , Gll         , Gs^Fms      , Gll         , Gs^Fms      , Gll         , Gll         
Gll^Ftr     , Md          , Md          , Md          , Md          , Md          , Md          , Hh          , Hh          , Hh          , Md          , Md          , Md          , Md          , Md          , Md          , Md          , Rp          , Gll^Ftr     , Wwt         , Wwt         , Wwt         , Wwt         , Md          , Wwt         , Md          , Wwt         , Wwt         , Wwt         , Wwt         , Wwt         , Wwt         , Wwt         , Wwt         , Wwt         , Ss          , Ss          , Ss          , Gll         , Gll         , Gll         , Gll         , Gll         , Rr          , Rr          , Gll^Fdw     , Rr          , Rr          , Gll         , Gll         , Gll         , Gll         , Gll         , Gll         
Gll^Ftr     , Gll^Ftr     , Gll^Ftr     , Md          , Gll^Ftr     , Hh          , Hh          , Hh          , Hh          , Hh          , Md          , Md          , Md          , Md          , Md          , Md          , Rp          , Rp          , Gll^Ftr     , Md          , Md          , Wwt         , Wwt         , Wwt         , Md          , Wwt         , Wwt         , Wwt         , Wwt         , Wwt         , Wwt         , Wwt         , Wwt         , Wwt         , Wwt         , Wwt         , Wwt         , Gll         , Gll         , Gll         , Gll         , Gll         , Gll         , Rr          , Rr          , Rr          , Rr          , Rr          , Gll         , Gll         , Gll         , Gll         , Gll         , Gll         
Gll^Ftr     , Gll^Ftr     , Gll^Ftr     , Gll^Ftr     , Gll^Ftr     , Gll^Ftr     , Gll^Ftr     , Hh          , Md          , Md          , Md          , Md          , Md          , Md          , Md          , Gll^Ftr     , Rp          , Rp          , Gll^Ftr     , Gll^Ftr     , Md          , Md          , Md          , Md          , Md          , Md          , Md          , Gll^Ftr     , Gll^Ftr     , Wwt         , Wwt         , Wwt         , Wwt         , Wwt         , Wwt         , Wwt         , Wwt         , Gll         , Wwt         , Gll         , Gll         , Gll         , Gll         , Rr          , Rr          , Rrc         , Rr          , Rr          , Gll         , Gll         , Gll         , Gll         , Gll         , Gll         
Gll^Ftr     , Gll^Ftr     , Gll^Ftr     , Gll^Ftr     , Gll^Ftr     , Gll^Ftr     , Gll^Ftr     , Md          , Md          , Md          , Md          , Md          , Md          , Md          , Gll^Ftr     , Gll^Ftr     , Rp          , Gll^Ftr     , Gll^Ftr     , Md          , Md          , Md          , Md          , Md          , Md          , Md          , Md          , Md          , Gll^Ftr     , Rp          , Gll^Ftr     , Gll^Ftr     , Md          , Md          , Md          , Wwt         , Wwt         , Wwt         , Wwt         , Wwt         , Wwt         , Wwt         , Chr         , Rr          , Rr          , Rr          , Rr          , Rr          , Chr         , Gll         , Ea          , Gll         , Gll         , Gll         
Md          , Gll^Ftr     , Gll^Ftr     , Gll^Ftr     , Gll^Ftr     , Gll^Ftr     , Gll^Ftr     , Md          , Gll^Ftr     , Md          , Md          , Md          , Md          , Md          , Md          , Gll^Ftr     , Rp          , Gll^Ftr     , Gll^Ftr     , Md          , Gll^Ftr     , Md          , Md          , Md          , Md          , Md          , Md          , Md          , Rp          , Rp          , Gll^Ftr     , Gll^Ftr     , Md          , Md          , Md          , Md          , Md          , Wwt         , Wwt         , Wwt         , Wwt         , Wwt         , Chr         , Rr          , Rr          , Rr          , Rr          , Rr          , Chr         , Wwt         , Wwt         , Wwt         , Wwt         , Gll         
Md          , Md          , Md          , Gll^Ftr     , Md          , Gll^Ftr     , Gll^Ftr     , Gll^Ftr     , Gll^Ftr     , Md          , Md          , Md          , Md          , Md          , Md          , Gll^Ftr     , Rp          , Rp          , Rrc         , Gll^Ftr     , Gll^Ftr     , Gll^Ftr     , Gll^Ftr     , Gll^Ftr     , Rrc         , Gll^Ftr     , Rp          , Rp          , Gll^Ftr     , Gll^Ftr     , Md          , Gll^Ftr     , Md          , Md          , Md          , Md          , Wwrg        , Wwrg        , Md          , Wwt         , Wwt         , Wwt         , Wwt         , Chr         , Chr         , Rr          , Chr         , Chr         , Wwt         , Wwt         , Wwt         , Wwt         , Wwt         , Gg          
Md          , Md          , Md          , Md          , Md          , Md          , Md          , Gll^Ftr     , Gll^Ftr     , Gll^Ftr     , Gll^Ftr     , Md          , Gll^Ftr     , Md          , Gll^Ftr     , Gll^Ftr     , Rp          , Rp          , Rrc         , Rrc         , Rrc         , Rrc         , Rrc         , Rrc         , Rrc         , Rp          , Rp          , Rp          , Gll^Ftr     , Md          , Md          , Md          , Ss          , Md          , Ss          , Wwrg        , Md          , Md          , Md          , Wwg         , Wwg         , Wwg         , Wwg         , Wwt         , Wwg         , Chr         , Wwt         , Wwt         , Wwt         , Wwt         , Wwt         , Wwt         , Wwt         , Wwt         
Md          , Md          , Md          , Md          , Md          , Md          , Md          , Md          , Gll^Ftr     , Gll^Ftr     , Gll^Ftr     , Gll^Ftr     , Gll^Ftr     , Gll^Ftr     , Gll^Ftr     , Gll^Ftr     , Gll^Ftr     , Rp          , Rrc         , Rrc         , Rrc         , Rrc         , Rrc         , Rrc         , Rrc         , Rp          , Rp          , Gll^Ftr     , Wwrg        , Md          , Md          , Md          , Ss          , Ss          , Md          , Md          , Md          , Md          , Hh          , Hh          , Wwg         , Wwg         , Wwg         , Wwg         , Wwg         , Wwg         , Wwg         , Wwt         , Wwt         , Wwt         , Wwt         , Wwt         , Wwt         , Wwt         
Md          , Md          , Md          , Md          , Md          , Md          , Md          , Md          , Md          , Gll^Ftr     , Gll^Ftr     , Gll^Ftr     , Md          , Md          , Md          , Gll^Ftr     , Rp          , Rp          , Rrc         , Rrc         , Rrc         , Urb         , Rrc         , Rrc         , Rrc         , Rp          , Rp          , Md          , Md          , Ss          , Ss          , Md          , Ss          , Md          , Md          , Md          , Hh          , Hh          , Hh          , Hh          , Hh          , Wwg         , Wwg         , Wwg         , Wwg         , Wwg         , Wwg         , Wwg         , Wwg         , Wwt         , Wwt         , Wwt         , Wwt         , Wwt         
Md          , Md          , Md          , Md          , Md          , Md          , Md          , Md          , Md          , Md          , Md          , Gll^Ftr     , Gll^Ftr     , Md          , Md          , Md          , Ea          , Rp          , Rrc         , Rrc         , Rrc         , Rrc         , Rrc         , Rrc         , Rrc         , Rp          , Ea          , Md          , Md          , Md          , Ss          , Ss          , Md          , Md          , Md          , Md          , Hh          , Hh          , Hh          , Hh          , Hh          , Hh          , Hh          , Wwg         , Gg^Fet      , Wwg         , Wwg         , Wwg         , Wwg         , Wwg         , Wwt         , Wwt         , Wwt         , Wwt         
Md          , Md          , Md          , Md          , Md          , Md          , Md          , Md          , Md          , Md          , Md          , Md          , Gll^Ftr     , Gll^Ftr     , Gll^Ftr     , Md          , Md          , Rp          , Rrc         , Rrc         , Rrc         , Rrc         , Rrc         , Rrc         , Rrc         , Rp          , Rp          , Gll^Ftr     , Gll^Ftr     , Wwrg        , Md          , Md          , Md          , Md          , Md          , Md          , Hh          , Hh          , Hh          , Hh          , Hh          , Hh          , Hh          , Hh          , Gg^Fet      , Wwrg        , Wwrg        , Wwrg        , Wwg         , Wwg         , Wwg         , Wwt         , Wwt         , Wwt         
Md          , Md          , Md          , Md          , Md          , Md          , Gll^Ftr     , Gll^Ftr     , Gll^Ftr     , Gll^Ftr     , Gll^Ftr     , Gll^Ftr     , Gll^Ftr     , Gll^Ftr     , Gll^Ftr     , Gll^Ftr     , Gll^Ftr     , Gll^Ftr     , Gll^Ftr     , Rp          , Rp          , Rp          , Rp          , Rp          , Rp          , Rp          , Rp          , Gll^Ftr     , Gll^Ftr     , Gll^Ftr     , Gll^Ftr     , Gll^Ftr     , Gll^Ftr     , Md          , Gll^Ftr     , Gll^Ftr     , Gll^Ftr     , Hh          , Md          , Hh          , Hh          , Hh          , Md          , Gg^Fet      , Gg^Fet      , Gg^Fet      , Gg^Fet      , Wwrg        , Wwrg        , Wwrg        , Wwrg        , Wwrg        , Wwrg        , Wwrg        
Md          , Md          , Md          , Md          , Md          , Gll^Ftr     , Gll^Ftr     , Gll^Ftr     , Gll^Ftr     , Gll^Ftr     , Gll^Ftr     , Gll^Ftr     , Gll^Ftr     , Gll^Ftr     , Gll^Ftr     , Gll^Ftr     , Gll^Ftr     , Gll^Ftr     , Gll^Ftr     , Gll^Ftr     , Rp          , Rp          , Rp          , Rp          , Rp          , Rp          , Gll^Ftr     , Gll^Ftr     , Gll^Ftr     , Gll^Ftr     , Gll^Ftr     , Gll^Ftr     , Gll^Ftr     , Gll^Ftr     , Gll^Ftr     , Gll^Ftr     , Gll^Ftr     , Hh          , Md          , Md          , Md          , Md          , Md          , Md          , Md          , Gg^Fet      , Gg^Fet      , Gg^Fet      , Wwrg        , Wwrg        , Wwrg        , Wwrg        , Wwrg        , Wwrg        
Md          , Md          , Md          , Md          , Md          , Gll^Ftr     , Gll^Ftr     , Gll^Ftr     , Gll^Ftr     , Gll^Ftr     , Gll^Ftr     , Gll^Ftr     , Gll^Ftr     , Gll^Ftr     , Gll^Ftr     , Gll^Ftr     , Md          , Gll^Ftr     , Md          , Md          , Md          , Rp          , Gll^Ftr     , Gll^Ftr     , Gll^Ftr     , Gll^Ftr     , Gll^Ftr     , Gll^Ftr     , Gll^Ftr     , Gll^Ftr     , Gll^Ftr     , Gll^Ftr     , Gll^Ftr     , Gll^Ftr     , Gll^Ftr     , Gll^Ftr     , Gll^Ftr     , Md          , Md          , Md          , Md          , Md          , Md          , Md          , Md          , Md          , Md          , Gg^Fet      , Gg^Fet      , Gg^Fet      , Gg^Fet      , Wwrg        , Wwrg        , Wwrg        
Md          , Md          , Md          , Md          , Md          , Md          , Md          , Gll^Ftr     , Gll^Ftr     , Gll^Ftr     , Gll^Ftr     , Gll^Ftr     , Gll^Ftr     , Md          , Md          , Md          , Md          , Md          , Md          , Md          , Md          , Md          , Rr          , Gll^Ftr     , Gll^Ftr     , Gll^Ftr     , Gll^Ftr     , Gll^Ftr     , Gll^Ftr     , Gll^Ftr     , Gll^Ftr     , Gll^Ftr     , Gll^Ftr     , Gll^Ftr     , Md          , Gll^Ftr     , Md          , Md          , Md          , Md          , Md          , Md          , Md          , Md          , Md          , Md          , Md          , Md          , Gg^Fet      , Gg^Fet      , Gg^Fet      , Wwrg        , Wwrg        , Wwrg        
Md          , Md          , Md          , Md          , Md          , Md          , Md          , Md          , Gll^Ftr     , Gll^Ftr     , Gll^Ftr     , Gll^Ftr     , Gll^Ftr     , Md          , Md          , Md          , Md          , Md          , Md          , Md          , Rr          , Rr          , Rr          , Rr          , Gs^Ftp      , Gs^Ftp      , Gs^Ftp      , Gll^Ftr     , Rr          , Rr          , Rr          , Gll^Ftr     , Gll^Ftr     , Md          , Md          , Md          , Md          , Md          , Md          , Md          , Md          , Md          , Md          , Md          , Md          , Md          , Md          , Md          , Md          , Gg^Fet      , Gg^Fet      , Gg^Fet      , Gg^Fet      , Gg^Fet      
