border_size=1
usage=map

Gg          , Gg          , Gg          , Gg          , Gg          , Gg          , Gg          , Mm          , Mm          , Mm          , Md^Xm       , Md^Xm       , Gll^Ftr     , Wo          , Hh          , Hh          , Hh          , Hh          , Hh          , Hh          , Hh          , Mm          , Mm          , Mm          , Mm          , Mm          , Mm          , Hh          , Wo          , Wo          , Wo          , Gll^Ftr     , Gll^Ftr     , Gll^Ftr     , Gll^Ftr     , Gll^Ftr     , Gll^Ftr     , Gll^Ftr     
Gg          , Gg          , Gg          , Gg          , Gg          , Gg          , Gg          , Mm          , Ea          , Mm          , Md^Xm       , Md^Xm       , Gll^Ftr     , Wo          , Hh          , Hh          , Hh          , Hh          , Hh          , Hh          , Mm          , Mm          , Mm          , Mm          , Mm          , Mm          , Mm          , Hh          , Wo          , Wo          , Wo          , Gll^Ftr     , Gll^Ftr     , Gll^Ftr     , Gll^Ftr     , Gll^Ftr     , Gll^Ftr     , Gll^Ftr     
Gg          , Gg          , Gg          , Gg          , Gg          , Gg          , Gg          , Gg          , Mm          , Mm          , Md^Xm       , Gll^Ftr     , Gll^Ftr     , Wo          , Hh          , Hh          , Hh          , Hh          , Hh          , Hh          , Mm          , Mm          , Mm          , Mm          , Mm          , Mm          , Mm          , Hh          , Wo          , Wo          , Wo          , Gll^Ftr     , Gll^Ftr     , Gll^Ftr     , Gll^Ftr     , Gll^Ftr     , Gll^Ftr     , Gll^Ftr     
Gg          , Gg          , Gg          , Gg          , Rp          , Gg          , Gg          , Gg          , Mm          , Mm          , Md^Xm       , Gll^Ftr     , Gll^Ftr     , Wwr         , Hh          , Hh          , Hh          , Hh          , Hh          , Hh          , Mm          , Mm          , Mm          , Mm          , Mm          , Mm          , Hh          , Hh          , Ss          , Wo          , Wo          , Wo          , Gll^Ftr     , Gll^Ftr     , Gll^Ftr     , Gll^Ftr     , Gll^Ftr     , Gll^Ftr     
Gg          , Gg          , Gg          , Gg          , Gg          , Gg          , Gg          , Gg          , Mm          , Mm          , Md^Xm       , Gll^Ftr     , Gll^Ftr     , Wo          , Hh          , Hh          , Hh          , Hh          , Mm          , Mm          , Mm          , Hh          , Hh          , Mm          , Hh          , Hh          , Rr          , Ss          , Ss          , Wo          , Wo          , Wo          , Gll^Ftr     , Gll^Ftr     , Gll^Ftr     , Gll^Ftr     , Gll^Ftr     , Gll^Ftr     
Gg          , Gg          , Gg          , Gg          , Gg          , Gg          , Gg          , Mm          , Mm          , Mm          , Md^Xm       , Md^Xm       , Mm          , Wo          , Wo          , Hh          , Mm          , Mm          , Mm          , Mm          , Mm          , Hh          , Hh          , Hh          , Ss          , Ss          , Ss          , Ss          , Ss          , Wo          , Wo          , Wo          , Gll^Ftr     , Gll^Ftr     , Gll^Ftr     , Gll^Ftr     , Gll^Ftr     , Gll^Ftr     
Gg          , Gg          , Gg          , Gg          , Gg          , Gg          , Mm          , Mm          , Mm          , Md^Xm       , Mm          , Mm          , Mm          , Mm          , Wo          , Mm          , Mm          , Mm          , Mm          , Mm          , Mm          , Hh          , Sm          , Sm          , Ss          , Ss          , Ss          , Ss          , Ss          , Wo          , Wo          , Wo          , Wo          , Gll^Ftr     , Gll^Ftr     , Gll^Ftr     , Gll^Ftr     , Gll^Ftr     
Gg          , Gg          , Gg          , Gg          , Gg          , Hh          , Mm          , Mm          , Mm          , Md^Xm       , Mm          , Mm          , Mm          , Mm          , Wo          , Mm          , Mm          , Mm          , Mm          , Mm          , Mm          , Sm          , Sm          , Sm          , Sm          , Ss          , Ss          , Ss          , Gll^Ftr     , Wo          , Wo          , Wo          , Wo          , Gll^Ftr     , Gll^Ftr     , Gll^Ftr     , Gll^Ftr     , Gll^Ftr     
Gg          , Gg          , Gg          , Gg          , Gg          , Hh          , Mm          , Mm          , Md^Xm       , Md^Xm       , Md^Xm       , Mm          , Mm          , Mm          , Wwr         , Mm          , Mm          , Mm          , Mm          , Mm          , Sm          , Sm          , Sm          , Sm          , Mm          , Mm          , Gll^Ftr     , Gll^Ftr     , Gll^Ftr     , Gll^Ftr     , Wo          , Wo          , Wo          , Wo          , Gll^Ftr     , Gll^Ftr     , Gll^Ftr     , Gll^Ftr     
Gg          , Gg          , Gg          , Gs^Fds      , Gs^Fds      , Gs^Fds      , Mm          , Mm          , Md^Xm       , Mm^Xm       , Md^Xm       , Mm          , Mm          , Mm          , Wwr         , Gs^Vc       , Gll^Ftr     , Mm          , Sm          , Sm          , Sm          , Sm          , Sm          , Sm          , Mm          , Mm          , Mm          , Gll^Ftr     , Gll^Ftr     , Gll^Ftr     , Wo          , Wo          , Wo          , Wo          , Gll^Ftr     , Gll^Ftr     , Gll^Ftr     , Gll^Ftr     
Gg          , Gs^Fds      , Gg          , Gg          , Gg          , Gs^Fds      , Mm          , Mm          , Mm          , Md^Xm       , Md^Xm       , Mm          , Mm          , Mm          , Wo          , Gll^Ftr     , Gll^Ftr     , Gll^Ftr     , Gll^Ftr     , Gll^Ftr     , Gll^Ftr     , Sm          , Sm          , Mm          , Mm          , Mm          , Mm          , Ss          , Ss          , Ss          , Wo          , Wo          , Wo          , Wo          , Gll^Ftr     , Gll^Ftr     , Gll^Ftr     , Gll^Ftr     
Gg          , Gg          , Ce          , Ce          , Ce          , Gs^Fds      , Mm          , Mm          , Mm          , Md^Xm       , Md^Xm       , Mm          , Mm          , Mm          , Wo          , Gll^Ftr     , Gll^Ftr     , Gll^Ftr     , Gll^Ftr     , Gll^Ftr     , Gll^Ftr     , Gll^Ftr     , Mm          , Mm          , Ms^Xm       , Mm          , Mm          , Ss          , Ss          , Ss          , Wo          , Wo          , Wo          , Wo          , Gll^Ftr     , Gll^Ftr     , Gll^Ftr     , Gll^Ftr     
Gg          , Gg          , Ce          , Gs^Vc       , Ce          , Hh          , Mm          , Mm          , Mm          , Md^Xm       , Mm          , Mm          , Mm          , Mm          , Wo          , Gll^Ftr     , Hh          , Hh          , Hh          , Gll^Ftr     , Gll^Ftr     , Gll^Ftr     , Mm          , Mm          , Ms^Xm       , Mm          , Mm          , Ss          , Ss          , Ss          , Wog         , Wo          , Wo          , Wo          , Wog         , Gll^Ftr     , Gll^Ftr     , Gll^Ftr     
Gg          , Gg          , Gs^Fds      , Ce          , Gs^Fds      , Hh          , Hh          , Mm          , Mm          , Md^Xm       , Mm          , Mm          , Mm          , Wo          , Gll^Ftr     , Gll^Ftr     , Md          , Md          , Md          , Hh          , Gll^Ftr     , Mm          , Mm          , Mm          , Ms^Xm       , Mm          , Mm          , Mm          , Gll^Ftr     , Gll^Ftr     , Wog         , Wog         , Wo          , Wo          , Wog         , Gll^Ftr     , Gll^Ftr     , Gll^Ftr     
Gs^Fds      , Gs^Fds      , Gs^Fds      , Gs^Fds      , Gs^Fds      , Gs^Fds      , Gs^Fds      , Mm          , Mm          , Md^Xm       , Mm          , Mm          , Mm          , Wo          , Gll^Ftr     , Gll^Ftr     , Md          , Md          , Hh          , Gll^Ftr     , Mm          , Mm          , Mm          , Ms^Xm       , Ms^Xm       , Mm          , Mm          , Mm          , Gll^Ftr     , Wog         , Wog         , Wog         , Wog         , Wog         , Wog         , Wog         , Wog         , Wog         
Gs^Fds      , Gs^Fds      , Gs^Fds      , Gs^Fds      , Gs^Fds      , Gs^Fds      , Gs^Fds      , Mm          , Mm          , Md^Xm       , Mm          , Mm          , Mm          , Wo          , Gll^Ftr     , Hh          , Hh          , Hh          , Hh          , Gll^Ftr     , Mm          , Mm          , Mm          , Ms^Xm       , Ms^Xm       , Mm          , Mm          , Mm          , Wog         , Wog         , Wog         , Wog         , Wog         , Wog         , Wog         , Wog         , Wog         , Wog         
Gs^Fds      , Gs^Fds      , Md          , Gs^Fds      , Gs^Fds      , Gs^Fds      , Gs^Fds      , Mm          , Mm          , Md^Xm       , Md^Xm       , Mm          , Wo          , Wo          , Gll^Ftr     , Hh          , Md          , Hh          , Hh          , Gll^Ftr     , Mm          , Mm          , Mm          , Ms^Xm       , Ms^Xm       , Mm          , Mm          , Mm          , Rrc         , Wog         , Rrc         , Wog         , Wog         , Wo          , Wog         , Wog         , Wog         , Wog         
Md          , Md          , Md          , Md          , Md          , Gs^Fds      , Gs^Fds      , Mm          , Mm          , Md^Xm       , Md^Xm       , Md^Xm       , Wo          , Gll^Ftr     , Gll^Ftr     , Hh          , Md          , Md          , Md          , Gll^Ftr     , Mm          , Mm          , Mm          , Ms^Xm       , Ms^Xm       , Mm          , Mm          , Mm          , Rrc         , Rrc         , Rrc         , Rrc         , Rrc         , Rrc         , Rrc         , Rrc         , Rrc         , Rrc         
Md          , Md          , Md          , Md          , Md          , Gs^Fds      , Gs^Fds      , Mm          , Mm          , Md^Xm       , Md^Xm       , Md^Xm       , Wo          , Gll^Ftr     , Gll^Ftr     , Gll^Ftr     , Gll^Ftr     , Md          , Md          , Gll^Ftr     , Mm          , Mm          , Mm          , Ms^Xm       , Ms^Xm       , Mm          , Mm          , Rrc         , Rrc         , Rrc         , Rrc         , Rrc         , Rrc         , Rrc         , Rrc         , Rrc         , Rrc         , Rrc         
Gs^Fds      , Md          , Gs^Fds      , Md          , Md          , Gs^Fds      , Gs^Fds      , Mm          , Mm          , Md^Xm       , Md^Xm       , Md^Xm       , Wo          , Gll^Ftr     , Rrc         , Gll^Ftr     , Gll^Ftr     , Gll^Ftr     , Gll^Ftr     , Gll^Ftr     , Gll^Ftr     , Mm          , Mm          , Ms^Xm       , Ms^Xm       , Mm          , Mm          , Rrc         , Rrc         , Rrc         , Rrc         , Rrc         , Rp          , Rrc         , Rrc         , Rrc         , Rrc         , Rrc         
Gs^Fds      , Gs^Fds      , Gs^Fds      , Gs^Fds      , Gg          , Gs^Fds      , Gs^Fds      , Gs^Fds      , Gs^Fds      , Gs^Fds      , Qxe         , Qxe         , Wo^Bw/      , Gg          , Gll^Ftr     , Gll^Ftr     , Gll^Ftr     , Gll^Ftr     , Gll^Ftr     , Hh          , Gll^Ftr     , Mm          , Mm          , Ms^Xm       , Ms^Xm       , Mm          , Mm          , Rrc         , Rrc         , Rrc         , Rrc         , Rrc         , Rrc         , Rrc         , Rrc         , Rrc         , Rrc         , Rrc         
Gs^Fds      , Gs^Fds      , Gs^Fds      , Gs^Fds      , Gg          , Gs^Fds      , Gg          , Gs^Fds      , Qxe         , Qxe         , Sm          , Sm          , Wo          , Gll^Ftr     , Gll^Ftr     , Gll^Ftr     , Gll^Ftr     , Gll^Ftr     , Gll^Ftr     , Hh          , Gll^Ftr     , Mm          , Mm          , Ms^Xm       , Ms^Xm       , Mm          , Mm          , Rrc         , Rrc         , Rrc         , Rrc         , Rrc         , Rrc         , Rrc         , Rrc         , Rrc         , Rrc         , Rrc         
Gs^Fds      , Gs^Fds      , Gs^Fds      , Gs^Fds      , Gs^Fds      , Gg          , Gs^Fds      , Gg          , Sm          , Sm          , Qxe         , Qxe         , Mm^Xm       , Wo          , Gg          , Gll^Ftr     , Gll^Ftr     , Gll^Ftr     , Gll^Ftr     , Gll^Ftr     , Mm          , Mm          , Mm          , Ms^Xm       , Ms^Xm       , Mm          , Mm          , Ea          , Rrc         , Rrc         , Rrc         , Rrc         , Rrc         , Rrc         , Rrc         , Rrc         , Rrc         , Rrc         
Gs^Fds      , Gs^Fds      , Gs^Fds      , Gs^Fds      , Gs^Fds      , Gs^Fds      , Gs^Fds      , Gs^Fds      , Gs^Fds      , Qxe         , Hh^Fms      , Mm^Xm       , Mm^Xm       , Wo          , Wo          , Gll^Ftr     , Gll^Ftr     , Gll^Ftr     , Gll^Ftr     , Gll^Ftr     , Mm          , Mm          , Ms^Xm       , Ms^Xm       , Ms^Xm       , Mm          , Mm          , Mm          , Ea          , Rrc         , Rrc         , Rrc         , Rrc         , Rrc         , Rrc         , Rrc         , Rrc         , Rrc         
Gs^Fds      , Gs^Fds      , Gs^Fds      , Gs^Fds      , Gs^Fds      , Gs^Fds      , Gs^Fds      , Gs^Fds      , Gs^Fds      , Gs^Fds      , Hh^Fms      , Hh^Fms      , Mm^Xm       , Mm^Xm       , Mm^Xm       , Wo          , Wo          , Gll^Ftr     , Gll^Ftr     , Gll^Ftr     , Mm          , Mm          , Ms^Xm       , Ms^Xm       , Ms^Xm       , Mm          , Mm          , Mm          , Rrc         , Rrc         , Rrc         , Rrc         , Rrc         , Rrc         , Rrc         , Rrc         , Rrc         , Rrc         
Hh^Fms      , Gs^Fds      , Gs^Fds      , Gs^Fds      , Gs^Fds      , Gs^Fds      , Gs^Fds      , Gs^Fds      , Gs^Fds      , Hh^Fms      , Hh^Fms      , Mm^Xm       , Mm^Xm       , Mm^Xm       , Mm^Xm       , Mm^Xm       , Wo          , Gll^Ftr     , Gll^Ftr     , Gll^Ftr     , Mm          , Mm          , Ms^Xm       , Ms^Xm       , Ms^Xm       , Ms^Xm       , Mm          , Mm          , Rrc         , Rrc         , Rrc         , Rrc         , Rrc         , Rrc         , Rrc         , Rrc         , Rrc         , Rrc         
