border_size=1
usage=map

Gs^Fds      , Gs^Fds      , Gs^Fds      , Gs^Fds      , Md          , Md          , Md          , Gs^Fds      , Md          , Gs^Fds      , Gs^Fds      , Gs^Fds      , Gs^Fds      , Gs^Fds      , Gs^Fds      , Gg          , Gg          , Gg          , Gg          , Gg          , Gg          , Gg          , Gg          , Gll^Ftr     , Ce          , Gll^Ftr     , Ce          , Gll^Ftr     , Ce          , Gg          , Md          , Gg          , Gs^Fds      , Gs^Fds      
Gs^Fds      , Gs^Fds      , Gs^Fds      , Gs^Fds      , Md          , Md          , Md          , Md          , Md          , Gs^Fds      , Gs^Fds      , Gs^Fds      , Gs^Fds      , Gs^Fds      , Gg          , Ce          , Ce          , Ce          , Ce          , Ce          , Ce          , Ce          , Ce          , Gll^Ftr     , Ce          , Ce          , Ce          , Gll^Ftr     , Ce          , Md          , Md          , Md          , Gs^Fds      , Gs^Fds      
Gs^Fds      , Gs^Fds      , Gs^Fds      , Gs^Fds      , Gs^Fds      , Md          , Md          , Md          , Md          , Md          , Md          , Gs^Fds      , Gs^Fds      , Gg          , Gg          , Ce          , Gll^Ftr     , Ea          , Ce          , Ce          , Gll^Ftr     , Ea          , Ce          , Gll^Ftr     , Gll^Ftr     , Gll^Ftr     , Ce          , Gll^Ftr     , Ce          , Md          , Md          , Md          , Gs^Fds      , Gs^Fds      
Gs^Fds      , Gs^Fds      , Gs^Fds      , Gs^Fds      , Gs^Fds      , Md          , Md          , Md          , Md          , Md          , Md          , Md          , Md          , Md          , Md          , Ce          , Gll^Ftr     , Gll^Ftr     , Ce          , Ce          , Rp          , Gll^Ftr     , Ce          , Gll^Ftr     , Gll^Ftr     , Gll^Ftr     , Gll^Ftr     , Gll^Ftr     , Md          , Md          , Md          , Md          , Gs^Fds      , Gs^Fds      
Gs^Fds      , Gs^Fds      , Gs^Fds      , Gs^Fds      , Gs^Fds      , Md          , Md          , Md          , Md          , Md          , Md          , Md          , Md          , Md          , Md          , Ce          , Rp          , Rp          , Rp          , Rp          , Rp          , Rp          , Rp          , Ce          , Gg          , Md          , Md          , Md          , Md          , Md          , Md          , Md          , Gs^Fds      , Gs^Fds      
Gs^Fds      , Gs^Fds      , Gs^Fds      , Gs^Fds      , Md          , Md          , Md          , Md          , Md          , Md          , Md          , Md          , Md          , Md          , Md          , Ce          , Rp          , Rp          , Rp          , Rp          , Rp          , Rp          , Rp          , Ce          , Gg          , Md          , Md          , Md          , Md          , Md          , Md          , Md          , Md          , Gs^Fds      
Gs^Fds      , Gs^Fds      , Gs^Fds      , Gs^Fds      , Md          , Md          , Md          , Md          , Md          , Md          , Md          , Md          , Md          , Md          , Md          , Ce          , Rp          , Rp          , Rp          , Rrc         , Rp          , Rp          , Rp          , Ce          , Gg          , Gg          , Md          , Md          , Md          , Md          , Md          , Md          , Md          , Md          
Gs^Fds      , Gs^Fds      , Gs^Fds      , Gs^Fds      , Md          , Md          , Md          , Md          , Ce          , Md          , Ce          , Md          , Md          , Md          , Md          , Ce          , Rp          , Rp          , Rp          , Rp          , Rp          , Rp          , Rp          , Ce          , Gg          , Gg          , Gg          , Md          , Gg          , Md          , Gg          , Md          , Md          , Md          
Gs^Fds      , Gs^Fds      , Gs^Fds      , Md          , Md          , Md          , Md          , Ce          , Ce          , Ce          , Ce          , Ce          , Gll^Ftr     , Md          , Md          , Ce          , Ce          , Rp          , Rp          , Rp          , Rp          , Rp          , Gll^Ftr     , Ce          , Gg          , Gg          , Gg          , Gg          , Gg          , Gg          , Gg          , Gg          , Gg          , Gg          
Gs^Fds      , Gs^Fds      , Md          , Md          , Md          , Md          , Gll^Ftr     , Ce          , Ce          , Ce          , Ce          , Ce          , Gll^Ftr     , Gll^Ftr     , Gll^Ftr     , Gll^Ftr     , Gll^Ftr     , Gll^Ftr     , Gll^Ftr     , Gll^Ftr     , Gll^Ftr     , Gll^Ftr     , Gll^Ftr     , Gll^Ftr     , Gg          , Gg          , Ce          , Ce          , Ce          , Ce          , Ce          , Gg          , Gg          , Gg          
Gs^Fds      , Gs^Fds      , Md          , Md          , Md          , Gll^Ftr     , Gg          , Gll^Ftr     , Gll^Ftr     , Gll^Ftr     , Gll^Ftr     , Gll^Ftr     , Gg          , Gg          , Gll^Ftr     , Gll^Ftr     , Ce          , Qlf         , Qlf         , Gll^Ftr     , Ce          , Gll^Ftr     , Ce          , Gll^Ftr     , Gg          , Gg          , Ce          , Gll^Ftr     , Ce          , Gll^Ftr     , Ce          , Gg          , Gg          , Gg          
Gs^Fds      , Gs^Fds      , Md          , Md          , Gll^Ftr     , Gll^Ftr     , Gg          , Gg          , Gg          , Gg          , Gg          , Gg          , Gg          , Gg          , Gll^Ftr     , Gll^Ftr     , Ce          , Ce          , Qlf         , Ce          , Ce          , Ce          , Ce          , Qlf         , Gll^Ftr     , Gg          , Ce          , Gll^Ftr     , Ce          , Gll^Ftr     , Ce          , Gg          , Gg          , Gg          
Md          , Gs^Fds      , Gg          , Md          , Gg          , Gg          , Gll^Ftr     , Gll^Ftr     , Gll^Ftr     , Gll^Ftr     , Gll^Ftr     , Gll^Ftr     , Gll^Ftr     , Gg          , Gg          , Gg          , Qlf         , Wot^Bw|     , Qlf         , Qlf         , Qlf         , Qlf         , Qlf         , Qlf         , Gg          , Gg          , Ce          , Gll^Ftr     , Ce          , Gll^Ftr     , Ce          , Gg          , Gg          , Gg          
Md          , Md          , Md          , Gg          , Gg          , Gll^Ftr     , Gll^Ftr     , Gll^Ftr     , Gll^Ftr     , Gll^Ftr     , Qlf         , Qlf         , Wwg^Bw|     , Qlf         , Qlf         , Qlf         , Qlf         , Wot         , Qlf         , Qlf         , Gg          , Gg          , Gg          , Gg          , Gg          , Gg          , Gg          , Gg          , Gg          , Gg          , Gg          , Gg          , Gg          , Gg          
Md          , Md          , Md          , Md          , Md          , Gll^Ftr     , Gll^Ftr     , Gll^Ftr     , Gll^Ftr     , Qlf         , Wwf         , Qlf         , Wwf^Bw|     , Qlf         , Wot         , Wot         , Wot         , Wot         , Wot         , Qlf         , Qlf         , Wwf^Bw|     , Qlf         , Gg          , Gg          , Md          , Md          , Gg          , Md          , Gg          , Md          , Md          , Md          , Gg          
Md          , Md          , Md          , Md          , Md          , Md          , Md          , Gll^Ftr     , Wwf         , Wwf         , Wwf         , Wot         , Wot^Bw|     , Wot         , Wot         , Wot         , Wot         , Wot         , Wot         , Wot         , Wot         , Wwf^Bw|     , Qlf         , Qlf         , Md          , Md          , Md          , Md          , Md          , Md          , Md          , Md          , Md          , Md          
Gs^Fds      , Md          , Md          , Md          , Md          , Md          , Md          , Wwf         , Wwf         , Wwf         , Wot         , Wot         , Wot         , Wot         , Wot         , Wot         , Wot         , Wot         , Wot         , Wot         , Wot         , Wot^Bw|     , Wot         , Qlf         , Md          , Md          , Md          , Md          , Md          , Md          , Md          , Md          , Md          , Md          
Gs^Fds      , Gs^Fds      , Md          , Md          , Md          , Md          , Md          , Qlf         , Qlf         , Qlf         , Wot         , Wot         , Wot         , Wot         , Wot         , Wot         , Wot         , Wot         , Wot         , Wot         , Wot         , Wot         , Wot         , Wot         , Md          , Md          , Md          , Md          , Md          , Md          , Md          , Md          , Md          , Md          
Gs^Fds      , Gs^Fds      , Gs^Fds      , Md          , Md          , Md          , Md          , Md          , Md          , Qlf         , Qlf         , Wot         , Wot         , Wot         , Wot         , Wot         , Wot         , Wot         , Wot         , Wot         , Wot         , Wot         , Wot         , Md          , Md          , Md          , Md          , Md          , Md          , Md          , Md          , Md          , Md          , Md          
Gs^Fds      , Gs^Fds      , Gs^Fds      , Md          , Md          , Md          , Md          , Md          , Md          , Md          , Wot         , Wot         , Wot         , Wot         , Wot         , Wot         , Qlf         , Qlf         , Md          , Wot         , Qlf         , Wot         , Wot         , Md          , Md          , Md          , Md          , Md          , Md          , Md          , Md          , Md          , Md          , Md          
Qlf         , Gs^Fds      , Qlf         , Qlf         , Qlf         , Md          , Md          , Md          , Md          , Md          , Wot         , Wot         , Wot         , Wot         , Wot         , Qlf         , Qlf         , Md          , Md          , Md          , Md          , Md          , Md          , Md          , Md          , Md          , Md          , Md          , Md          , Md          , Md          , Md          , Md          , Md          
Qlf         , Qlf         , Qlf         , Qlf         , Qlf         , Qlf         , Qlf         , Qlf         , Qlf         , Qlf         , Qxu^Bw|     , Wot         , Wot         , Wot         , Wot         , Wot         , Md          , Md          , Md          , Md          , Md          , Md          , Md          , Md          , Md          , Md          , Md          , Md          , Ce          , Ea          , Ce          , Md          , Md          , Md          
Qlf         , Qlf         , Qlf         , Qlf         , Qlf         , Qlf         , Qlf         , Qlf         , Qlf         , Qlf         , Qxu^Bw|     , Qlf         , Wot         , Wot         , Wot         , Wot         , Qlf         , Md          , Qlf         , Md          , Md          , Md          , Md          , Md          , Md          , Md          , Ce          , Ce          , Ce          , Ce          , Ce          , Ce          , Ce          , Gs^Fds      
Qlf         , Qlf         , Qlf         , Qlf         , Qlf         , Qlf         , Qlf         , Qlf         , Qlf         , Qlf         , Qxu^Bw|     , Qlf         , Wot         , Wot         , Wot         , Wot         , Wot         , Qlf         , Qlf         , Md          , Md          , Md          , Md          , Md          , Ce          , Ce          , Ce          , Ce          , Gs^Fds      , Gs^Fds      , Gs^Fds      , Ce          , Ce          , Ce          
Gll^Ftr     , Gll^Ftr     , Gll^Ftr     , Qlf         , Ea          , Qlf         , Qlf         , Qlf         , Qlf         , Qxu         , Ce          , Qlf         , Qlf         , Wot         , Wot         , Wot         , Wot         , Wot         , Qlf         , Qlf         , Md          , Md          , Md          , Md          , Ce          , Ce          , Gs^Fds      , Gs^Fds      , Urb         , Urb         , Urb         , Gs^Fds      , Gs^Fds      , Ce          
Gll^Ftr     , Gll^Ftr     , Gll^Ftr     , Gll^Ftr     , Gll^Ftr     , Gll^Ftr     , Gll^Ftr     , Qlf         , Gll^Ftr     , Qlf         , Qlf         , Qxu^Bw\r    , Qxu^Bw\r    , Qlf         , Qlf         , Wot         , Wot         , Wot         , Wot         , Wot         , Wot         , Wot         , Wot^Bw/     , Wot^Bw/     , Ce          , Gs^Fds      , Gs^Fds      , Urb         , Urb         , Urb         , Urb         , Urb         , Gs^Fds      , Gs^Fds      
Gll^Ftr     , Gll^Ftr     , Gll^Ftr     , Gll^Ftr     , Gll^Ftr     , Gll^Ftr     , Gll^Ftr     , Gll^Ftr     , Gll^Ftr     , Gll^Ftr     , Gll^Ftr     , Qlf         , Qlf         , Qxu^Bw\r    , Qxu^Bw\r    , Qlf         , Qlf         , Wot         , Wot         , Wot         , Wot^Bw/     , Wot^Bw/     , Wot         , Wot         , Ce          , Gs^Fds      , Gs^Fds      , Urb         , Urb         , Urb         , Urb         , Urb         , Gs^Fds      , Gs^Fds      
Gll^Ftr     , Gll^Ftr     , Gll^Ftr     , Gll^Ftr     , Gll^Ftr     , Gll^Ftr     , Gll^Ftr     , Gll^Ftr     , Gll^Ftr     , Gll^Ftr     , Gll^Ftr     , Gll^Ftr     , Qlf         , Qlf         , Qlf         , Qxu^Bw\r    , Qxu^Bw\r    , Qlf         , Wot^Bw/     , Wot^Bw/     , Wot         , Wot         , Wot         , Wot         , Ce          , Gs^Fds      , Gs^Fds      , Urb         , Urb         , Rr          , Urb         , Urb         , Gs^Fds      , Gs^Fds      
Gll^Ftr     , Gll^Ftr     , Gg          , Gg          , Gg          , Gll^Ftr     , Gll^Ftr     , Gll^Ftr     , Qlf         , Gll^Ftr     , Qlf         , Qlf         , Qlf         , Qlf         , Ce          , Qlf         , Wot         , Cud         , Wot^Bw\r    , Wot         , Wot         , Wot         , Wot         , Wot         , Ce          , Gs^Fds      , Gs^Fds      , Urb         , Urb         , Urb         , Urb         , Urb         , Gs^Fds      , Gs^Fds      
Gll^Ftr     , Gll^Ftr     , Gg          , Rr          , Gg          , Gll^Ftr     , Gll^Ftr     , Gll^Ftr     , Qlf         , Ce          , Qlf         , Qlf         , Qlf         , Qlf         , Qlf^Bw|     , Qlf^Bw\r    , Wot         , Wot^Bw|r    , Wot         , Wot^Bw\r    , Wot^Bw\r    , Wot         , Wot         , Wot         , Ce          , Gs^Fds      , Gs^Fds      , Urb         , Gs^Fds      , Urb         , Gs^Fds      , Urb         , Gs^Fds      , Gs^Fds      
Gll^Ftr     , Gll^Ftr     , Gll^Ftr     , Gg          , Gll^Ftr     , Gll^Ftr     , Gll^Ftr     , Qlf         , Qlf         , Qlf^Bw|r    , Qlf         , Qlf         , Wot         , Qlf         , Ce          , Qlf         , Qlf         , Wot^Bw|r    , Qlf         , Wot         , Wot         , Wot^Bw\r    , Wot^Bw\r    , Wot         , Ce          , Gs^Fds      , Gs^Fds      , Gs^Fds      , Gs^Fds      , Gs^Fds      , Gs^Fds      , Gs^Fds      , Gs^Fds      , Gs^Fds      
Gll^Ftr     , Gll^Ftr     , Gll^Ftr     , Gll^Ftr     , Gll^Ftr     , Gll^Ftr     , Qlf         , Qlf         , Qlf^Bw/r    , Ce          , Qlf         , Wot         , Wot         , Wot         , Qlf         , Qlf^Bw\     , Qlf^Bw\     , Wot^Bw|r    , Qlf         , Wot         , Qlf         , Wot         , Wot         , Wot^Bw\r    , Ce          , Gs^Fds      , Gs^Fds      , Gs^Fds      , Ce          , Gs^Fds      , Ce          , Gs^Fds      , Ce          , Gs^Fds      
Gll^Ftr     , Gll^Ftr     , Gll^Ftr     , Gll^Ftr     , Gll^Ftr     , Qlf         , Qlf^Bw/     , Ce          , Qlf^Bw\r    , Qlf         , Wot         , Wot         , Wot         , Qlf         , Wot         , Qlf         , Qlf^Bw/     , Ce          , Qlf^Bw\     , Qlf         , Wot         , Wot         , Wot         , Wot         , Wot         , Ce          , Ce          , Ce          , Wot         , Ea          , Wot         , Ce          , Wot         , Ce          
Gll^Ftr     , Gll^Ftr     , Qlf         , Gll^Ftr     , Ce          , Qlf^Bw/     , Qlf         , Qlf         , Wot         , Wot^Bw\r    , Wot^Bw\r    , Wot         , Wot         , Wot         , Wot^Bw/     , Wot^Bw/     , Qlf         , Qlf         , Qlf         , Qlf^Bw\     , Wot         , Wot         , Wot         , Wot         , Wot         , Wot         , Wot         , Wot         , Wot         , Wot         , Wot         , Wot         , Wot         , Wot         
Gll^Ftr     , Qlf         , Qlf         , Qlf         , Qlf         , Qlf         , Qlf         , Qlf         , Wot         , Wot         , Wot         , Wot^Bw\r    , Ce          , Wot^Bw/     , Wot         , Wot         , Wot         , Qlf         , Qlf         , Qlf         , Wot         , Wot         , Wot         , Wot         , Wot         , Wot         , Wot         , Wot         , Wot         , Wot         , Wot         , Wot         , Wot         , Wot         
Qlf         , Qlf         , Qlf         , Qlf         , Qlf         , Qlf         , Qlf         , Wot         , Wot         , Wot         , Wot         , Wot         , Wot         , Wot         , Wot         , Wot         , Wot         , Wot         , Wot         , Wot         , Wot         , Wot         , Wot         , Wot         , Wot         , Wot         , Wot         , Wot         , Wot         , Wot         , Wot         , Wot         , Wot         , Wot         
Wot         , Qlf         , Qlf         , Qlf         , Qlf         , Qlf         , Wot         , Wot         , Wot         , Wot         , Wot         , Wot         , Wot         , Wot         , Wot         , Wot         , Wot         , Wot         , Wot         , Wot         , Wot         , Wot         , Wot         , Wot         , Wot         , Wot         , Wot         , Wot         , Wot         , Wot         , Wot         , Wot         , Wot         , Wot         
