border_size=1
usage=map

Md          , Md          , Md          , Md          , Md          , Md          , Md          , Md          , Md          , Md          , Dd          , Dd          , Dd          , Dd          , Md          , Md          , Md          , Md          , Md          , Md          , Md          , Md          , Md          , Md          , Md          , Md          , Md          , Md          , Mm          , Mm          , Mm          , Mm          , Mm          , Mm          , Mm          , Gg          , Mm          , Mm          , Mm          , Gg          , Gg          , Gg          , Gg          , Gg          , Md          , Gg          , Md          , Md          , Md          , Md          , Gll^Ftr     , Gll^Ftr     , Gll^Ftr     , Gg          , Md          , Md          , Md          , Md          , Md          , Gg          
Dd          , Md          , Dd          , Md          , Dd          , Md          , Md          , Md          , Dd          , Dd          , Dd          , Dd          , Dd          , Dd          , Dd          , Md          , Md          , Md          , Md          , Md          , Md          , Md          , Md          , Md          , Md          , Md          , Mm          , Mm          , Mm          , Mm          , Mm          , Mm          , Mm^Xm       , Mm          , Mm          , Mm          , Mm          , Mm          , Mm          , Gg          , Gg          , Gg          , Gg          , Gg          , Md          , Md          , Md          , Md          , Md          , Md          , Gg          , Gll^Ftr     , Gg          , Gll^Ftr     , Md          , Md          , Md          , Md          , Md          , Md          
Dd          , Dd          , Dd          , Dd          , Dd          , Dd          , Dd          , Dd          , Dd          , Dd          , Dd          , Dd          , Dd          , Dd          , Dd          , Dd          , Md          , Md          , Md          , Md          , Md          , Md          , Md          , Md          , Md          , Md          , Mm          , Mm          , Mm^Xm       , Mm          , Mm^Xm       , Mm^Xm       , Mm^Xm       , Mm^Xm       , Mm^Xm       , Mm^Xm       , Mm^Xm       , Mm          , Mm          , Gg          , Wwf         , Wwf         , Wwf         , Wwf         , Wwf         , Md          , Md          , Md          , Md          , Md          , Wwf         , Gg          , Gg          , Gg          , Md          , Md          , Md          , Md          , Md          , Md          
Dd          , Dd          , Dd          , Dd          , Dd          , Dd          , Dd^Edp      , Dd^Edp      , Dd^Edp      , Dd          , Dd          , Dd          , Dd          , Dd          , Dd          , Dd          , Dd          , Md          , Md          , Md          , Md          , Md          , Md          , Md          , Md          , Md          , Mm^Xm       , Mm^Xm       , Mm^Xm       , Mm^Xm       , Mm          , Mm          , Gll^Ftr     , Mm          , Gll^Ftr     , Mm          , Mm^Xm       , Mm          , Mm          , Mm          , Wwf         , Wwf         , Wwf         , Wwf         , Gll^Ftr     , Md          , Md          , Md          , Md          , Wwf         , Wwf         , Gg          , Md          , Md          , Md          , Md          , Md          , Md          , Md          , Md          
Dd          , Ch          , Ch          , Ch          , Ch          , Ch          , Ch          , Ch          , Ch          , Ch          , Ch          , Ch          , Ch          , Ch          , Ch          , Ch          , Wwg         , Wwg         , Wwg         , Md          , Md          , Md          , Md          , Md          , Md          , Md          , Mm^Xm       , Mm          , Gll^Ftr     , Ea          , Gll^Ftr     , Gll^Ftr     , Gll^Ftr     , Gll^Ftr     , Gll^Ftr     , Ch          , Mm^Xm       , Mm^Xm       , Mm          , Mm          , Gg          , Wwf         , Gll^Ftr     , Gll^Ftr     , Gll^Ftr     , Gll^Ftr     , Gll^Ftr     , Md          , Gll^Ftr     , Wwf         , Gll^Ftr     , Wwf         , Md          , Md          , Md          , Md          , Md          , Md          , Md          , Md          
Dd          , Ea          , Ch          , Dd          , Dd          , Dd          , Dd          , Dd          , Dd          , Dd          , Dd          , Dd          , Dd          , Ch          , Dd          , Dd          , Wwg         , Wwg         , Wwg         , Md          , Uh          , Md          , Md          , Md          , Md          , Md          , Mm^Xm       , Gll^Ftr     , Gll^Ftr     , Gll^Ftr     , Rp          , Gll^Ftr     , Rp          , Rp          , Rp          , Ch          , Ch          , Mm          , Mm          , Mm          , Mm          , Gg          , Gll^Ftr     , Gll^Ftr     , Gll^Ftr     , Gll^Ftr     , Gll^Ftr     , Gll^Ftr     , Gll^Ftr     , Gll^Ftr     , Gg          , Gll^Ftr     , Md          , Md          , Md          , Md          , Md          , Md          , Md          , Md          
Dd          , Ch          , Ch          , Dd          , Dd          , Dd          , Dd          , Dd          , Dd          , Dd          , Dd          , Dd          , Dd          , Ch          , Wwg         , Wwg         , Wwg         , Wwg         , Uh          , Uh          , Uh          , Uh          , Uh          , Md          , Uh          , Md          , Md          , Mm^Xm       , Rp          , Rp          , Rp          , Rp          , Rp          , Rp          , Rp          , Ch          , Ch          , Mm          , Mm          , Mm          , Gg          , Gg          , Gll^Ftr     , Gll^Ftr     , Gll^Ftr     , Gll^Ftr     , Gll^Ftr     , Gll^Ftr     , Gg          , Gg          , Gg          , Gg          , Gg          , Md          , Gg          , Md          , Md          , Md          , Md          , Md          
Dd          , Dd          , Dd          , Dd          , Dd          , Dd          , Dd          , Dd          , Dd          , Dd          , Dd          , Dd          , Dd          , Ch          , Wwg         , Wwg         , Qxu^Bs/     , Uh          , Uh          , Uh          , Md          , Uh          , Uh          , Uh          , Uh          , Uh          , Uh          , Rp          , Rp          , Rp          , Rp          , Rp          , Rp          , Rp          , Rp          , Ch          , Ch          , Gg          , Gg          , Gg          , Gg          , Gg          , Gg          , Gg          , Md          , Gg          , Md          , Md          , Md          , Gg          , Gg          , Gg          , Gg          , Gg          , Gg          , Gg          , Gg          , Md          , Md          , Md          
Dd          , Dd          , Dd          , Dd          , Dd          , Dd          , Dd          , Dd          , Dd          , Dd          , Dd          , Dd          , Ds          , Ch          , Qxu^Bs/     , Qxu^Bs/     , Wwg         , Wwg         , Wwg         , Md          , Md          , Md          , Md          , Md          , Md          , Uh          , Uh          , Rp          , Rp          , Rp          , Rp          , Rrc         , Rp          , Rp          , Rp          , Ch          , Ch          , Gg          , Gg          , Gg          , Gg          , Gg          , Mm^Xm       , Md          , Md          , Md          , Md          , Md          , Md          , Wwf         , Wwf         , Gll^Ftr     , Gll^Ftr     , Gll^Ftr     , Gll^Ftr     , Gg          , Gg          , Gg          , Wwf         , Wwf         
Dd          , Dd          , Dd          , Dd          , Dd          , Dd          , Dd          , Rp          , Dd          , Dd          , Dd          , Ds          , Ds          , Ch          , Ds          , Wwg         , Wwg         , Wwg         , Wwg         , Md          , Md          , Md          , Md          , Md          , Uh          , Uh          , Rp          , Rp          , Rp          , Rp          , Rp          , Rp          , Rp          , Rp          , Rp          , Ch          , Ch          , Gg          , Gg          , Gg          , Mm^Xm       , Mm^Xm       , Mm^Xm       , Md          , Md          , Md          , Md          , Md          , Md          , Wwf         , Wwf         , Wwf         , Gll^Ftr     , Gll^Ftr     , Gll^Ftr     , Gll^Ftr     , Gll^Ftr     , Gg          , Wwf         , Wwf         
Dd          , Dd          , Ch          , Dd          , Dd          , Dd          , Dd          , Dd          , Dd          , Dd          , Dd          , Ds          , Ds^Edp      , Ch          , Ds          , Ds          , Ds          , Wwg         , Wwg         , Wwg         , Wwg         , Md          , Md          , Uh          , Uh          , Uh          , Md          , Rp          , Rp          , Rp          , Gll^Ftr     , Rp          , Rp          , Rp          , Gll^Ftr     , Ch          , Ch          , Gg          , Mm^Xm       , Mm^Xm       , Mm^Xm       , Mm^Xm       , Mm^Xm       , Md          , Md          , Md          , Md          , Md          , Md          , Md          , Gg          , Wwf         , Gll^Ftr     , Gll^Ftr     , Gll^Ftr     , Gll^Ftr     , Gll^Ftr     , Gg          , Gg          , Wwf         
Dd          , Dd          , Ch          , Dd          , Dd^Ftd      , Dd          , Dd          , Dd          , Dd          , Dd          , Dd          , Dd          , Dd          , Ch          , Ds          , Ds          , Ds          , Ds          , Ds          , Wwg         , Wwg         , Wwg         , Uh          , Uh          , Uh          , Md          , Md          , Md          , Gll^Ftr     , Gll^Ftr     , Gll^Ftr     , Gll^Ftr     , Gll^Ftr     , Gll^Ftr     , Mm          , Ch          , Mm^Xm       , Mm^Xm       , Mm^Xm       , Mm^Xm       , Mm^Xm       , Mm^Xm       , Md          , Md          , Md          , Md          , Md          , Md          , Gg          , Md          , Gg          , Gg          , Wwf         , Gll^Ftr     , Gg          , Gll^Ftr     , Gg          , Gg          , Md          , Md          
Dd          , Dd          , Ch          , Dd          , Dd          , Dd          , Dd          , Dd          , Dd          , Dd          , Dd          , Dd          , Dd          , Ch          , Dd          , Ds          , Dd          , Ds          , Dd^Ftd      , Wwg         , Wwg         , Wwg         , Wwg         , Uh          , Md          , Md          , Md          , Md          , Md          , Ea          , Mm          , Gll^Ftr     , Mm          , Mm          , Mm          , Mm          , Mm^Xm       , Mm^Xm       , Mm^Xm       , Mm^Xm       , Md          , Md          , Gll^Ftr     , Gg          , Gg          , Gg          , Gll^Ftr     , Gg          , Wwf         , Wwf         , Wwf         , Wwf         , Wwf         , Wwf         , Wwf         , Gg          , Md          , Md          , Md          , Md          
Dd          , Ch          , Ch          , Dd          , Ch          , Dd          , Ch          , Dd          , Ch          , Dd          , Ch          , Dd          , Ch          , Ch          , Ch          , Dd          , Dd          , Dd^Ftd      , Dd^Ftd      , Ds          , Wwg         , Wwg         , Wwg         , Md          , Md          , Md          , Md          , Md          , Mm          , Mm          , Mm          , Mm          , Mm          , Mm          , Mm^Xm       , Mm^Xm       , Mm^Xm       , Mm^Xm       , Mm          , Mm          , Gll^Ftr     , Gll^Ftr     , Gll^Ftr     , Wwf         , Wwf         , Gll^Ftr     , Gll^Ftr     , Gll^Ftr     , Gll^Ftr     , Gll^Ftr     , Gll^Ftr     , Md          , Md          , Md          , Md          , Md          , Md          , Md          , Md          , Md          
Dd          , Ea          , Ch          , Ch          , Dd          , Ch          , Dd          , Ch          , Dd          , Ch          , Dd          , Ch          , Dd          , Ch          , Dd          , Ch          , Dd          , Dd          , Ds          , Ds          , Wwg         , Wwg         , Wwg         , Md          , Md          , Md          , Md          , Md          , Mm^Xm       , Mm          , Mm^Xm       , Mm          , Mm^Xm       , Mm^Xm       , Mm^Xm       , Mm^Xm       , Mm          , Mm          , Mm          , Mm          , Gll^Ftr     , Gll^Ftr     , Gll^Ftr     , Wwf         , Wwf         , Wwf         , Md          , Gll^Ftr     , Md          , Gll^Ftr     , Md          , Md          , Md          , Md          , Md          , Md          , Md          , Md          , Md          , Md          
Dd          , Ch          , Dd          , Dd          , Dd          , Dd          , Dd          , Dd          , Dd          , Dd          , Dd          , Dd          , Md          , Md          , Md          , Md          , Md          , Md          , Md          , Ds          , Ds          , Wwg         , Md          , Mm^Xm       , Mm^Xm       , Mm^Xm       , Mm^Xm       , Mm^Xm       , Mm^Xm       , Mm^Xm       , Mm^Xm       , Mm^Xm       , Mm          , Mm          , Mm          , Mm          , Mm          , Mm          , Ce          , Mm          , Ce          , Gll^Ftr     , Wwf         , Gll^Ftr     , Ce          , Wwf         , Ce          , Md          , Md          , Md          , Md          , Md          , Md          , Md          , Md          , Md          , Md          , Md          , Md          , Md          
Dd          , Dd          , Dd          , Dd          , Dd          , Dd          , Dd          , Dd          , Dd          , Dd          , Dd          , Dd          , Md          , Md          , Md          , Md          , Md          , Md          , Md          , Md          , Md          , Md          , Md          , Md          , Md          , Mm^Xm       , Md          , Mm^Xm       , Md          , Md          , Md          , Mm          , Mm          , Mm          , Gll^Ftr     , Mm          , Gll^Ftr     , Gll^Ftr     , Gll^Ftr     , Ce          , Ce          , Ce          , Ce          , Ce          , Ce          , Ce          , Gg          , Gg          , Gg          , Md          , Ea          , Md          , Gll^Ftr     , Ce          , Ce          , Md          , Wwg         , Md          , Md          , Md          
Dd          , Dd          , Dd          , Dd          , Dd          , Dd          , Dd          , Dd          , Hh          , Hh          , Hh          , Hh          , Hh          , Md          , Md          , Md          , Md          , Md          , Md          , Md          , Md          , Md          , Md          , Md          , Md          , Md          , Md          , Md          , Md          , Md          , Md          , Md          , Md          , Md          , Gll^Ftr     , Gll^Ftr     , Gll^Ftr     , Gll^Ftr     , Gg          , Gg          , Gg          , Gg          , Gg          , Gg          , Gg          , Gg          , Gg          , Gg          , Gg          , Gg          , Gll^Ftr     , Gll^Ftr     , Gll^Ftr     , Ce          , Ce          , Wwg         , Wwg         , Wwg         , Wwg         , Wwg         
Dd          , Dd          , Md          , Md          , Md          , Dd          , Hh          , Hh          , Hh          , Hh          , Hh          , Hh          , Hh          , Hh          , Md          , Md          , Md          , Md          , Md          , Md          , Md          , Md          , Md          , Md          , Md          , Md          , Md          , Md          , Md          , Md          , Md          , Md          , Md          , Md          , Gll^Ftr     , Gll^Ftr     , Gll^Ftr     , Gll^Ftr     , Gll^Ftr     , Gg          , Gg          , Gg          , Gg          , Gg          , Gg          , Gg          , Gg          , Gg          , Gg          , Gg          , Gll^Ftr     , Gll^Ftr     , Gll^Ftr     , Gll^Ftr     , Gll^Ftr     , Ce          , Wwg         , Wwg         , Wwg         , Wwg         
Dd          , Md          , Md          , Md          , Md          , Hh          , Hh          , Hh          , Hh          , Hh          , Hh          , Hh          , Hh          , Hh          , Md          , Md          , Md          , Md          , Md          , Md          , Md          , Md          , Md          , Md          , Md          , Md          , Md          , Md          , Md          , Md          , Md          , Md          , Md          , Md          , Md          , Gll^Ftr     , Gll^Ftr     , Gll^Ftr     , Gll^Ftr     , Gll^Ftr     , Gg          , Gg          , Gg          , Gg          , Gg          , Rr          , Gg          , Gg          , Gg          , Gg          , Gg          , Gll^Ftr     , Gll^Ftr     , Gll^Ftr     , Ce          , Ce          , Wwg         , Wwg         , Wwg         , Wwg         
Md          , Md          , Md          , Md          , Md          , Md          , Hh          , Hh          , Gll^Ftr     , Hh          , Gll^Ftr     , Gll^Ftr     , Gll^Ftr     , Gll^Ftr     , Gll^Ftr     , Md          , Md          , Md          , Md          , Md          , Md          , Md          , Md          , Md          , Md          , Md          , Md          , Md          , Md          , Md          , Md          , Md          , Md          , Md          , Md          , Md          , Md          , Md          , Md          , Gll^Ftr     , Gll^Ftr     , Gll^Ftr     , Wwf         , Gg          , Gg          , Gg          , Gg          , Gg          , Gg          , Gg          , Gll^Ftr     , Gll^Ftr     , Gll^Ftr     , Gll^Ftr     , Ce          , Wwg         , Wwg         , Wwg         , Wwg         , Wwg         
Md          , Md          , Md          , Md          , Md          , Md          , Gll^Ftr     , Gll^Ftr     , Gll^Ftr     , Gll^Ftr     , Gll^Ftr     , Gll^Ftr     , Gll^Ftr     , Gll^Ftr     , Gll^Ftr     , Gll^Ftr     , Gll^Ftr     , Md          , Md          , Md          , Md          , Md          , Md          , Md          , Md          , Md          , Md          , Md          , Md          , Md          , Md          , Md          , Md          , Md          , Md          , Md          , Md          , Md          , Ea          , Gll^Ftr     , Gll^Ftr     , Wwf         , Gg          , Gg          , Gg          , Gg          , Gg          , Wwf         , Wwf         , Gg          , Gll^Ftr     , Gll^Ftr     , Gll^Ftr     , Ce          , Wwg         , Wwg         , Wwg         , Wwg         , Wwg         , Wwg         
Md          , Md          , Md          , Md          , Md          , Md          , Gll^Ftr     , Gll^Ftr     , Gll^Ftr     , Gll^Ftr     , Gll^Ftr     , Gll^Ftr     , Gll^Ftr     , Gll^Ftr     , Gll^Ftr     , Gll^Ftr     , Gll^Ftr     , Md          , Md          , Md          , Md          , Md          , Gll^Ftr     , Md          , Md          , Md          , Md          , Md          , Md          , Md          , Md          , Md          , Md          , Md          , Md          , Md          , Md          , Md          , Md          , Gll^Ftr     , Gll^Ftr     , Gll^Ftr     , Ss          , Ss          , Ss          , Gg          , Gg          , Wwf         , Gg          , Gll^Ftr     , Gll^Ftr     , Gll^Ftr     , Gll^Ftr     , Ce          , Wwg         , Wwg         , Wwg         , Wwg         , Wwg         , Wwg         
