border_size=1
usage=map

Hh          , Hh          , Hh          , Hh          , Hh          , Md          , Md          , Md          , Md          , Md          , Md          , Md          , Md          , Gg          , Md          , Md          , Md          , Md          , Wwg         , Gg^Fet      , Gg^Fet      , Gg^Fet      , Gg^Fet      , Gg          , Gg^Fet      , Gg^Fet      , Gg^Fet      , Gg^Fet      , Gg^Fet      , Gg          , Wwg         , Wwg         , Wwg         , Wwg         
Hh          , Hh          , Hh          , Hh          , Hh          , Hh          , Hh          , Md          , Md          , Md          , Md          , Md          , Md          , Md          , Md          , Md          , Wwg         , Wwg         , Wwg         , Gg^Fet      , Gg          , Gg          , Gg          , Gg          , Gg          , Gg          , Gg          , Gg          , Gg          , Gg          , Ea          , Wwg         , Gll^Ftr     , Wwg         
Hh          , Hh          , Hh          , Hh          , Hh          , Hh          , Hh          , Md          , Md          , Md          , Md          , Md          , Md          , Md          , Wwg         , Wwg         , Wwg         , Wwg         , Wwf         , Gg^Fet      , Gg          , Gg          , Gg          , Gg          , Gg          , Gg          , Gg          , Gg          , Gg          , Gg          , Gg          , Gll^Ftr     , Gll^Ftr     , Gll^Ftr     
Hh          , Hh          , Hh          , Hh          , Hh          , Hh          , Hh          , Md          , Md          , Md          , Md          , Md          , Md          , Md          , Qxe         , Wwf         , Wwf         , Wwf         , Qxe         , Gg          , Gg          , Gg          , Gg          , Gg          , Rp          , Gg          , Gg          , Gg          , Gg          , Gg          , Gg          , Gll^Ftr     , Gll^Ftr     , Gll^Ftr     
Hh          , Hh          , Hh          , Rp          , Hh          , Hh          , Hh          , Md          , Md          , Md          , Md          , Md          , Md          , Md          , Ce          , Qxe         , Qxu^Bs/     , Wwf         , Qxe         , Gg          , Gg          , Gg          , Gg          , Gg          , Gg          , Gg          , Gg          , Gg          , Gg          , Gg          , Gg          , Gll^Ftr     , Gll^Ftr     , Gll^Ftr     
Hh          , Hh          , Hh          , Hh          , Hh          , Hh          , Hh          , Hh          , Md          , Md          , Md          , Md          , Md          , Md          , Ce          , Ce          , Ce          , Qxe         , Md          , Gll^Ftr     , Gll^Ftr     , Gg          , Gg          , Gg          , Gg          , Gg          , Gg          , Gg          , Gg          , Gg          , Gll^Ftr     , Gll^Ftr     , Ce          , Gll^Ftr     
Hh          , Hh          , Hh          , Hh          , Hh          , Hh          , Hh          , Hh          , Hh          , Md          , Md          , Md          , Md          , Md          , Md          , Ce          , Ce          , Md          , Md          , Md          , Md          , Gll^Ftr     , Gll^Ftr     , Gg          , Gll^Ftr     , Gg          , Gll^Ftr     , Gll^Ftr     , Gll^Ftr     , Gll^Ftr     , Ce          , Ce          , Ce          , Ce          
Hh          , Hh          , Hh          , Hh          , Hh          , Hh          , Hh          , Hh          , Hh          , Md          , Md          , Md          , Md          , Md          , Md          , Wwg         , Wwg         , Wwg         , Wwg         , Md          , Md          , Md          , Md          , Gll^Ftr     , Ea          , Gll^Ftr     , Md          , Gll^Ftr     , Ce          , Ce          , Ce          , Ce          , Wwg         , Wwg         
Gll^Ftr     , Hh          , Hh          , Hh          , Gll^Ftr     , Hh          , Hh          , Hh          , Md          , Md          , Md          , Md          , Md          , Md          , Wwg         , Wwg         , Wwg         , Wwg         , Wwg         , Wwg         , Md          , Md          , Md          , Md          , Md          , Md          , Md          , Md          , Md          , Ce          , Wwg         , Wwg         , Wwg         , Wwg         
Gll^Ftr     , Gll^Ftr     , Gll^Ftr     , Gll^Ftr     , Gll^Ftr     , Gll^Ftr     , Gll^Ftr     , Gll^Ftr     , Gll^Ftr     , Md          , Md          , Md          , Md          , Md          , Md          , Wwg         , Gg          , Gll^Ftr     , Gll^Ftr     , Md          , Md          , Md          , Md          , Md          , Md          , Md          , Md          , Md          , Md          , Wwg         , Wwg         , Wwg         , Wwg         , Wwg         
Gll^Ftr     , Gll^Ftr     , Gll^Ftr     , Gll^Ftr     , Gll^Ftr     , Gll^Ftr     , Gll^Ftr     , Gll^Ftr     , Gll^Ftr     , Qxu         , Qxu         , Md          , Md          , Md          , Md          , Gll^Ftr     , Gll^Ftr     , Gg          , Gg          , Hh          , Hh          , Hh          , Hh          , Md          , Md          , Md          , Md          , Md          , Md          , Wwg         , Wwg         , Wwg         , Wwg         , Wwg         
Ww          , Gll^Ftr     , Ww          , Gll^Ftr     , Gll^Ftr     , Gll^Ftr     , Gll^Ftr     , Gll^Ftr     , Gll^Ftr     , Qxu         , Qxu         , Md          , Ww          , Md          , Ww          , Gll^Ftr     , Gll^Ftr     , Gg          , Gll^Ftr     , Gg          , Gg          , Hh          , Hh          , Hh          , Hh          , Md          , Md          , Md          , Wwg         , Wwg         , Wwg         , Wwg         , Wwg         , Wwg         
Ww          , Ww          , Ww          , Ww          , Gll^Ftr     , Gll^Ftr     , Qxu         , Gll^Ftr     , Qxu         , Qxu         , Ww          , Ww          , Ww          , Ww          , Ww          , Ww          , Ww          , Gll^Ftr     , Gll^Ftr     , Gll^Ftr     , Gll^Ftr     , Gg          , Gg          , Hh          , Hh          , Md          , Md          , Md          , Md          , Wwg         , Gll^Ftr     , Gll^Ftr     , Gll^Ftr     , Wwg         
Ww          , Ww          , Ww          , Ww          , Ww          , Qxu         , Md          , Qxu         , Md          , Qxu         , Md          , Ww          , Ww          , Ww          , Ww          , Ww          , Ww          , Ww          , Ww          , Ww          , Ww          , Gll^Ftr     , Ww          , Hh          , Ww          , Md          , Md          , Md          , Md          , Gll^Ftr     , Gll^Ftr     , Gll^Ftr     , Gll^Ftr     , Gll^Ftr     
Md          , Ww          , Ww          , Ww          , Ww          , Md          , Md          , Md          , Md          , Md          , Gll^Ftr     , Gg          , Gg          , Ww          , Gll^Ftr     , Ww          , Gg          , Ww          , Ww          , Ww          , Ww          , Ww          , Ww          , Ww          , Md          , Md          , Md          , Md          , Md          , Md          , Gll^Ftr     , Gll^Ftr     , Gll^Ftr     , Gll^Ftr     
Md          , Md          , Gll^Ftr     , Ww          , Ww          , Md          , Md          , Md          , Md          , Md          , Gg          , Gg          , Gg          , Gll^Ftr     , Gll^Ftr     , Gll^Ftr     , Gg          , Md          , Md          , Md          , Md          , Ww          , Ww          , Ww          , Md          , Md          , Md          , Md          , Md          , Md          , Gll^Ftr     , Gll^Ftr     , Gll^Ftr     , Gll^Ftr     
Md          , Md          , Gll^Ftr     , Md          , Md          , Md          , Md          , Md          , Gg          , Gg          , Gg          , Gg          , Gg          , Gg          , Gg          , Gg          , Gg          , Gll^Ftr     , Gll^Ftr     , Md          , Md          , Md          , Md          , Md          , Md          , Md          , Md          , Md          , Md          , Md          , Md          , Gll^Ftr     , Gll^Ftr     , Gll^Ftr     
Md          , Gll^Ftr     , Md          , Md          , Md          , Md          , Md          , Md          , Gg          , Gg          , Gg          , Gg          , Gg          , Gg          , Gg          , Gg          , Gg          , Gg          , Gg          , Md          , Md          , Md          , Md          , Md          , Md          , Md          , Md          , Md          , Md          , Md          , Md          , Gll^Ftr     , Gll^Ftr     , Gg          
Md          , Gll^Ftr     , Gll^Ftr     , Md          , Md          , Md          , Md          , Gll^Ftr     , Gg          , Gg          , Gg          , Gg          , Gg          , Rr          , Gg          , Gg          , Gg          , Gg          , Gg          , Gll^Ftr     , Md          , Md          , Md          , Md          , Md          , Md          , Md          , Md          , Gll^Ftr     , Gll^Ftr     , Gll^Ftr     , Gll^Ftr     , Gg          , Gg          
Md          , Gll^Ftr     , Md          , Gll^Ftr     , Md          , Md          , Md          , Ea          , Gll^Ftr     , Gg          , Gll^Ftr     , Gg          , Gg          , Gg          , Gg          , Gg          , Gg          , Gll^Ftr     , Gg          , Ea          , Md          , Md          , Md          , Md          , Gll^Ftr     , Gll^Ftr     , Gll^Ftr     , Gll^Ftr     , Gg          , Gg          , Gg          , Gg          , Gg          , Gg          
Wwt         , Md          , Wwt         , Gll^Ftr     , Md          , Md          , Md          , Md          , Md          , Gll^Ftr     , Gll^Ftr     , Gll^Ftr     , Gg          , Gg          , Gg          , Gg          , Gg          , Gg          , Gll^Ftr     , Md          , Md          , Md          , Md          , Md          , Gg          , Gll^Ftr     , Gg          , Gg          , Gg          , Gg          , Gg          , Gg          , Gll^Ftr     , Gll^Ftr     
Wwt         , Wwt         , Wwt^Bw|     , Wwt         , Wwt         , Md          , Md          , Md          , Md          , Md          , Gll^Ftr     , Gll^Ftr     , Gll^Ftr     , Gll^Ftr     , Gll^Ftr     , Gll^Ftr     , Gll^Ftr     , Gll^Ftr     , Gll^Ftr     , Md          , Gll^Ftr     , Md          , Gg          , Gg          , Gg          , Gg          , Gll^Ftr     , Gg          , Gll^Ftr     , Gll^Ftr     , Gll^Ftr     , Gll^Ftr     , Wwt         , Wwt         
Wwt         , Wwt         , Wwt^Bw|     , Wwt         , Wwt         , Wwt         , Wwt         , Wwt         , Wwt         , Wwt         , Wwt         , Gll^Ftr     , Gll^Ftr     , Gll^Ftr     , Gll^Ftr     , Gll^Ftr     , Gll^Ftr     , Gll^Ftr     , Gll^Ftr     , Gll^Ftr     , Gg          , Gg          , Gg          , Gll^Ftr     , Gll^Ftr     , Gll^Ftr     , Wwt         , Gll^Ftr     , Wwt         , Wwt         , Wwt         , Wwt         , Wwt         , Wwt         
Wwt         , Wwt         , Wwt^Bw|     , Wwt         , Wwt         , Wwt         , Wwt         , Wwt         , Wwt         , Wwt         , Wwt         , Wwt         , Wwt         , Wwt         , Wwt         , Gll^Ftr     , Wwt         , Gll^Ftr     , Wwt         , Gg          , Wwt         , Gg          , Wwt         , Gg          , Wwt         , Wwt         , Wwt         , Wwt         , Wwt         , Wwt         , Wwt         , Wwt         , Wwt         , Wwt         
Wwt         , Wwt         , Wwt^Bw|     , Wwt         , Wwt         , Wwt         , Wwt         , Wwt         , Wwt         , Wwt         , Wwt         , Wwt         , Wwt         , Wwt         , Wwt         , Wwt         , Wwt         , Wwt         , Wwt         , Wwt         , Wwt         , Wwt         , Wwt         , Wwt         , Wwt         , Wwt         , Wwt         , Wwt         , Wwt         , Wwt         , Wwt         , Wwt         , Wwt         , Wwt         
Wwt         , Wwt         , Wwt^Bw|     , Wwt         , Wwt         , Wwt         , Wwt         , Wwt         , Wwt         , Wwt         , Wwt         , Wwt         , Wwt         , Wwt         , Wwt         , Wwt         , Wwt         , Wwt         , Wwt         , Wwt         , Wwt         , Wwt         , Wwt         , Wwt         , Wwt         , Wwt         , Wwt         , Wwt         , Wwt         , Wwt         , Wwt         , Wwt         , Wwt         , Wwt         
Wwt         , Wwt         , Wwt^Bw|     , Wwt         , Wwt         , Wwt         , Wwt         , Wwt         , Wwt         , Wwt         , Wwt         , Wwt         , Wwt         , Wwt         , Wwt         , Wwt         , Wwt         , Wwt         , Wwt         , Wwt         , Wwt         , Wwt         , Wwt         , Wwt         , Wwt         , Wwt         , Wwt         , Wwt         , Wwt         , Wwt         , Wwt         , Wwt         , Wwt         , Wwt         
Gs^Fds      , Gs^Fds      , Rr          , Wwt         , Md          , Md          , Md          , Gs^Fds      , Md          , Wwt         , Gs^Fds      , Wwt         , Gs^Fds      , Wwt         , Wwt         , Wwt         , Wwt         , Wwt         , Wwt         , Wwt         , Wwt         , Wwt         , Wwt         , Gll^Ftr     , Ce          , Gll^Ftr     , Ce          , Gll^Ftr     , Ce          , Wwt         , Md          , Wwt         , Gs^Fds      , Gs^Fds      
Gs^Fds      , Gs^Fds      , Rr          , Gs^Fds      , Md          , Md          , Md          , Md          , Md          , Gs^Fds      , Gs^Fds      , Gs^Fds      , Gs^Fds      , Gs^Fds      , Gg          , Ce          , Ce          , Ce          , Ce          , Ce          , Ce          , Ce          , Ce          , Gll^Ftr     , Ce          , Ce          , Ce          , Gll^Ftr     , Ce          , Md          , Md          , Md          , Gs^Fds      , Gs^Fds      
Gs^Fds      , Gs^Fds      , Rr          , Rr          , Rr          , Md          , Md          , Md          , Md          , Md          , Md          , Gs^Fds      , Gs^Fds      , Gg          , Rr          , Ce          , Gll^Ftr     , Ea          , Ce          , Ce          , Gll^Ftr     , Ea          , Ce          , Gll^Ftr     , Gll^Ftr     , Gll^Ftr     , Ce          , Gll^Ftr     , Ce          , Md          , Md          , Md          , Gs^Fds      , Gs^Fds      
Gs^Fds      , Gs^Fds      , Gs^Fds      , Gs^Fds      , Gs^Fds      , Rr          , Rr          , Md          , Rr          , Md          , Rr          , Md          , Rr          , Rr          , Md          , Ce          , Gll^Ftr     , Gll^Ftr     , Ce          , Ce          , Rp          , Gll^Ftr     , Ce          , Gll^Ftr     , Gll^Ftr     , Gll^Ftr     , Gll^Ftr     , Gll^Ftr     , Md          , Md          , Md          , Md          , Gs^Fds      , Gs^Fds      
Gs^Fds      , Gs^Fds      , Gs^Fds      , Gs^Fds      , Gs^Fds      , Md          , Md          , Rr          , Md          , Rr          , Md          , Rr          , Md          , Md          , Md          , Ce          , Rp          , Rp          , Rp          , Rp          , Rp          , Rp          , Rp          , Ce          , Gg          , Md          , Md          , Md          , Md          , Md          , Md          , Md          , Gs^Fds      , Gs^Fds      
Gs^Fds      , Gs^Fds      , Gs^Fds      , Gs^Fds      , Md          , Md          , Md          , Md          , Md          , Md          , Md          , Md          , Md          , Md          , Md          , Ce          , Rp          , Rp          , Rp          , Rp          , Rp          , Rp          , Rp          , Ce          , Gg          , Md          , Md          , Md          , Md          , Md          , Md          , Md          , Md          , Gs^Fds      
Gs^Fds      , Gs^Fds      , Gs^Fds      , Gs^Fds      , Md          , Md          , Md          , Md          , Md          , Md          , Md          , Md          , Md          , Md          , Md          , Ce          , Rp          , Rp          , Rp          , Rrc         , Rp          , Rp          , Rp          , Ce          , Gg          , Gg          , Md          , Md          , Md          , Md          , Md          , Md          , Md          , Md          
Gs^Fds      , Gs^Fds      , Gs^Fds      , Gs^Fds      , Md          , Md          , Md          , Md          , Ce          , Md          , Ce          , Md          , Md          , Md          , Md          , Ce          , Rp          , Rp          , Rp          , Rp          , Rp          , Rp          , Rp          , Ce          , Gg          , Gg          , Gg          , Md          , Gg          , Md          , Gg          , Md          , Md          , Md          
Gs^Fds      , Gs^Fds      , Gs^Fds      , Md          , Md          , Md          , Md          , Ce          , Ce          , Ce          , Ce          , Ce          , Gll^Ftr     , Md          , Md          , Ce          , Ce          , Rp          , Rp          , Rp          , Rp          , Rp          , Gll^Ftr     , Ce          , Gg          , Gg          , Gg          , Gg          , Gg          , Gg          , Gg          , Gg          , Gg          , Gg          
Gs^Fds      , Gs^Fds      , Md          , Md          , Md          , Md          , Gll^Ftr     , Ce          , Ce          , Ce          , Ce          , Ce          , Gll^Ftr     , Gll^Ftr     , Gll^Ftr     , Gll^Ftr     , Gll^Ftr     , Gll^Ftr     , Gll^Ftr     , Gll^Ftr     , Gll^Ftr     , Gll^Ftr     , Gll^Ftr     , Gll^Ftr     , Gg          , Gg          , Ce          , Ce          , Ce          , Ce          , Ce          , Gg          , Gg          , Gg          
Gs^Fds      , Gs^Fds      , Md          , Md          , Md          , Gll^Ftr     , Gg          , Gll^Ftr     , Gll^Ftr     , Gll^Ftr     , Gll^Ftr     , Gll^Ftr     , Gg          , Mm          , Gll^Ftr     , Gll^Ftr     , Ce          , Gll^Ftr     , Gll^Ftr     , Gll^Ftr     , Ce          , Gll^Ftr     , Ce          , Gll^Ftr     , Gg          , Gg          , Ce          , Gll^Ftr     , Ce          , Gll^Ftr     , Ce          , Gg          , Gg          , Gg          
Gs^Fds      , Gs^Fds      , Md          , Md          , Gll^Ftr     , Gll^Ftr     , Gg          , Gg          , Gg          , Gg          , Gg          , Gg          , Gg          , Gg          , Gll^Ftr     , Gll^Ftr     , Ce          , Ce          , Gll^Ftr     , Ce          , Ce          , Ce          , Ce          , Gll^Ftr     , Gll^Ftr     , Gg          , Ce          , Gll^Ftr     , Ce          , Gll^Ftr     , Ce          , Gg          , Gg          , Gg          
Md          , Gs^Fds      , Gg          , Md          , Gg          , Gg          , Gll^Ftr     , Gll^Ftr     , Gll^Ftr     , Gll^Ftr     , Gll^Ftr     , Gll^Ftr     , Gll^Ftr     , Gg          , Gg          , Gg          , Gll^Ftr     , Wot^Bw|     , Gll^Ftr     , Gll^Ftr     , Gll^Ftr     , Gll^Ftr     , Gll^Ftr     , Gll^Ftr     , Gg          , Gg          , Ce          , Gll^Ftr     , Ce          , Gll^Ftr     , Ce          , Gg          , Gg          , Gg          
