border_size=1
usage=map

Hd          , Hd          , Hd          , Hd          , Hd          , Hd          , Hd          , Hd          , Hd          , Hd          , Hd          , Hd          , Hd          , Hd          , Hd          , Hd          , Hd          , Hd          , Hd          , Hd          , Hd          , Re          , Hd          , Hd          , Hd          , Hd          , Hd          , Hd          , Hd          , Hd          , Hd          , Hd          , Hhd         , Hhd         , Hhd         , Hhd         , Hhd         , Hhd         
Hd          , Hd          , Hd          , Hd          , Hd          , Hd          , Hd          , Hd          , Hd          , Hd          , Hd          , Hd          , Hd          , Hd          , Hd          , Hd          , Hd          , Hd          , Hd          , Hd          , Hd          , Hd          , Hd          , Hd          , Hd          , Hd          , Hd          , Hd          , Hd          , Hd          , Hd          , Hd          , Hd          , Hhd         , Hhd         , Hhd         , Hhd         , Hhd         
Hd          , Hd          , Hd          , Hd          , Hd          , Hd          , Hd          , Hd          , Hd          , Hd          , Hd          , Hd          , Hd          , Hd          , Hd          , Hd          , Hd          , Hd          , Hd          , Hd          , Hd          , Hd          , Hd          , Hd          , Hd          , Hd          , Hd          , Hd          , Hd          , Hd          , Hd          , Hd          , Hhd         , Hhd         , Hhd         , Hhd         , Hhd         , Hhd         
Hd          , Hd          , Hd          , Hd          , Hd          , Hd          , Hd          , Hd          , Hd          , Hd          , Hd          , Hd          , Hd          , Hd          , Hd          , Hd          , Hd          , Hd          , Hd          , Hd          , Hhd         , Hhd         , Hhd         , Hd          , Hhd         , Hhd         , Hhd         , Hhd         , Hhd         , Hd          , Hhd         , Hd          , Hhd         , Hhd         , Hhd         , Hhd         , Hhd         , Hhd         
Md          , Hd          , Hd          , Hd          , Hd          , Hd          , Hd          , Hd          , Hd          , Hd          , Hd          , Hd          , Hd          , Hd          , Md          , Md          , Md          , Hd          , Md          , Md          , Ce          , Ce          , Ce          , Ce          , Ce          , Ce          , Ce          , Ce          , Ce          , Ce          , Md          , Hhd         , Md          , Hhd         , Hhd         , Hhd         , Hhd         , Hhd         
Md          , Md          , Md          , Hh          , Md          , Hd          , Md          , Hd          , Md          , Md          , Md          , Md          , Md          , Md          , Md          , Md          , Md          , Md          , Md          , Md          , Ce          , Gg          , Gg          , Gg          , Gg          , Gg          , Gg          , Gg          , Gg          , Ce          , Md          , Md          , Md          , Md          , Md          , Hhd         , Hhd         , Hhd         
Md          , Md          , Md          , Hh          , Hh          , Md          , Md          , Md          , Md          , Md          , Md          , Md          , Md          , Md          , Md          , Md          , Md          , Md          , Md          , Md          , Ce          , Gg          , Gg          , Gg          , Gg          , Gg          , Gg          , Gg          , Gg          , Ce          , Md          , Md          , Md          , Md          , Md          , Hhd         , Hhd         , Hhd         
Md          , Md          , Md          , Hh          , Md          , Hh          , Hh          , Md          , Md          , Md          , Md          , Md          , Md          , Md          , Md          , Md          , Md          , Md          , Md          , Md          , Ce          , Gg          , Gg          , Gg          , Rp          , Gg          , Gg          , Gg          , Gg          , Ce          , Md          , Md          , Md          , Md          , Md          , Hhd         , Hhd         , Hhd         
Md          , Md          , Md          , Md          , Md          , Md          , Md          , Hh          , Md          , Md          , Md          , Md          , Md          , Md          , Mm          , Md          , Md          , Md          , Md          , Md          , Ce          , Gg          , Gg          , Gg          , Gg          , Gg          , Gg          , Gg          , Gg          , Ce          , Md          , Md          , Md          , Md          , Md          , Hhd         , Hhd         , Hhd         
Md          , Md          , Md          , Md          , Hh          , Md          , Hh          , Hh          , Md          , Md          , Md          , Md          , Md          , Md          , Md          , Md          , Md          , Md          , Md          , Md          , Ce          , Gg          , Ce          , Gg          , Gg          , Gg          , Ce          , Gg          , Ce          , Ce          , Md          , Md          , Md          , Md          , Mm^Xm       , Hhd         , Hhd         , Hhd         
Md          , Md          , Hh          , Hh          , Md          , Hh          , Md          , Md          , Md          , Md          , Md          , Md          , Md          , Md          , Md          , Md          , Md          , Md          , Md          , Ce          , Ce          , Ce          , Ms^Xm       , Ce          , Ce          , Ce          , Ce          , Ce          , Md          , Ce          , Mm^Xm       , Mm^Xm       , Mm^Xm       , Mm^Xm       , Mm^Xm       , Mm^Xm       , Mm^Xm       , Mm^Xm       
Md          , Md          , Md          , Hh          , Hh          , Hh          , Hh          , Md          , Md          , Md          , Md          , Md          , Md          , Md          , Md          , Md          , Md          , Md          , Md          , Md          , Mm^Xm       , Mm^Xm       , Mm^Xm       , Mm^Xm       , Md          , Md          , Gll^Ftr     , Gll^Ftr     , Gll^Ftr     , Md          , Md          , Mm^Xm       , Mm^Xm       , Mm^Xm       , Mm^Xm       , Mm^Xm       , Mm^Xm       , Mm^Xm       
Md          , Md          , Md          , Md          , Md          , Md          , Md          , Hh          , Hh          , Md          , Md          , Md          , Md          , Md          , Md          , Md          , Md          , Md          , Mm^Xm       , Mm^Xm       , Mm^Xm       , Mm^Xm       , Md          , Md          , Md          , Md          , Ch          , Gll^Ftr     , Ch          , Ea          , Ch          , Mm^Xm       , Ch          , Mm^Xm       , Mm^Xm       , Mm^Xm       , Mm^Xm       , Mm^Xm       
Md          , Md          , Md          , Md          , Md          , Md          , Hh          , Hh          , Md          , Md          , Md          , Md          , Md          , Md          , Mm^Xm       , Md          , Mm^Xm       , Mm^Xm       , Mm^Xm       , Mm^Xm       , Hh          , Md          , Md          , Md          , Ch          , Ch          , Gg^Gvs      , Ch          , Gg^Gvs      , Ch          , Gg^Gvs      , Ch          , Gg^Gvs      , Ch          , Mm^Xm       , Mm^Xm       , Mm^Xm       , Mm^Xm       
Md          , Md          , Md          , Md          , Hh          , Hh          , Hh          , Hh          , Md          , Md          , Hh          , Md          , Md          , Md          , Mm^Xm       , Mm^Xm       , Hh          , Mm^Xm       , Hh          , Hh          , Hh          , Hh          , Gll^Ftr     , Gll^Ftr     , Ch          , Ch          , Gg^Gvs      , Gg^Gvs      , Gg^Gvs      , Gg^Gvs      , Gg^Gvs      , Gg^Gvs      , Gg^Gvs      , Ch          , Mm^Xm       , Mm^Xm       , Mm^Xm       , Mm^Xm       
Md          , Md          , Hh          , Hh          , Md          , Md          , Md          , Md          , Hh          , Md          , Hh          , Hh          , Hh          , Md          , Hh          , Mm^Xm       , Hh          , Hh          , Hh          , Hh          , Hh          , Hh          , Gll^Ftr     , Gll^Ftr     , Ch          , Ch          , Gg^Gvs      , Gg^Gvs      , Gg^Gvs      , Gg^Gvs      , Gg^Gvs      , Gg^Gvs      , Gg^Gvs      , Ch          , Gll^Ftr     , Mm^Xm       , Gll^Ftr     , Mm^Xm       
Md          , Hh          , Hh          , Md          , Md          , Md          , Md          , Hh          , Hh          , Hh          , Hh          , Hh          , Hh          , Hh          , Hh          , Hh          , Hh          , Hh          , Hh          , Hh          , Md          , Hh          , Md          , Gll^Ftr     , Ch          , Ch          , Gg^Gvs      , Gg^Gvs      , Gg^Gvs      , Rp          , Gg^Gvs      , Gg^Gvs      , Gg^Gvs      , Ch          , Gll^Ftr     , Gll^Ftr     , Gll^Ftr     , Gll^Ftr     
Md          , Hh          , Hh          , Hh          , Hh          , Md          , Hh          , Hh          , Hh          , Hh          , Hh          , Rp          , Hh          , Hh          , Hh          , Hh          , Hh          , Hh          , Md          , Md          , Md          , Md          , Md          , Md          , Ch          , Ch          , Gg^Gvs      , Gg^Gvs      , Gg^Gvs      , Gg^Gvs      , Gg^Gvs      , Gg^Gvs      , Gg^Gvs      , Ch          , Gll^Ftr     , Gll^Ftr     , Gll^Ftr     , Gll^Ftr     
Md          , Md          , Md          , Md          , Md          , Hh          , Md          , Hh          , Hh          , Hh          , Hh          , Hh          , Hh          , Hh          , Hh          , Hh          , Md^Xm       , Md          , Md^Xm       , Md          , Md          , Md          , Md^Xm       , Md          , Md^Xm       , Ch          , Ch          , Ch          , Ch          , Ch          , Ch          , Ch          , Ch          , Ch          , Gll^Ftr     , Gll^Ftr     , Md          , Gll^Ftr     
Md          , Md          , Md          , Md          , Md          , Md          , Md          , Md          , Md          , Hh          , Hh          , Hh          , Gll^Ftr     , Hh          , Gll^Ftr     , Gll^Ftr     , Md          , Md^Xm       , Md^Xm       , Md^Xm       , Md^Xm       , Md^Xm       , Md^Xm       , Md^Xm       , Md^Xm       , Md^Xm       , Md^Xm       , Md^Xm       , Md^Xm       , Md^Xm       , Md^Xm       , Gg          , Md^Xm       , Ea          , Md          , Md          , Md          , Md          
Md          , Md          , Md          , Md          , Md          , Md          , Md          , Md          , Md          , Md          , Gll^Ftr     , Gll^Ftr     , Gll^Ftr     , Hh          , Hh          , Gll^Ftr     , Gll^Ftr     , Md          , Md          , Md          , Md          , Md          , Md          , Md          , Md          , Md          , Md          , Md          , Md          , Md^Xm       , Md^Xm       , Md^Xm       , Md^Xm       , Md^Xm       , Md^Xm       , Md          , Md          , Md          
Md          , Md          , Md          , Md          , Md          , Md          , Md          , Md          , Md          , Md          , Gll^Ftr     , Gll^Ftr     , Gll^Ftr     , Hh          , Ss          , Hh          , Hh          , Hh          , Hh          , Md          , Gll^Ftr     , Md          , Md          , Md          , Ss          , Ss          , Gll^Ftr     , Md          , Md          , Md          , Md          , Md          , Md          , Md^Xm       , Md          , Md          , Md          , Md          
Md          , Md          , Md          , Md          , Md          , Md          , Md          , Md          , Md          , Md          , Md          , Md          , Md          , Ss          , Md          , Ss          , Md          , Gll^Ftr     , Md          , Hh          , Hh          , Hh          , Hh          , Hh          , Hh          , Gll^Ftr     , Gll^Ftr     , Gll^Ftr     , Gll^Ftr     , Gll^Ftr     , Gll^Ftr     , Md          , Md          , Md          , Md          , Md          , Md          , Md          
Md          , Md          , Md          , Md          , Md          , Md          , Md          , Md          , Md          , Md          , Md          , Md          , Md          , Md          , Md          , Md          , Md          , Md          , Md          , Md          , Md          , Gll^Ftr     , Gll^Ftr     , Gll^Ftr     , Hh          , Gll^Ftr     , Gll^Ftr     , Gll^Ftr     , Gll^Ftr     , Gll^Ftr     , Gll^Ftr     , Md          , Md          , Md          , Md          , Md          , Md          , Md          
Md          , Md          , Md          , Md          , Md          , Md          , Md^Xm       , Md          , Md^Xm       , Md          , Md^Xm       , Md^Xm       , Md^Xm       , Md^Xm       , Md^Xm       , Md          , Md^Xm       , Md          , Md          , Md          , Md          , Md          , Md          , Gll^Ftr     , Hh          , Gll^Ftr     , Md          , Md          , Md          , Gll^Ftr     , Gll^Ftr     , Gll^Ftr     , Hh          , Md          , Md          , Md          , Md          , Md          
Gll^Ftr     , Md          , Gll^Ftr     , Md          , Md          , Md          , Md^Xm       , Md^Xm       , Md^Xm       , Md^Xm       , Md^Xm       , Md^Xm       , Md^Xm       , Md^Xm       , Md^Xm       , Md^Xm       , Md^Xm       , Md^Xm       , Md^Xm       , Md          , Md          , Md          , Md          , Md          , Gll^Ftr     , Hh          , Gll^Ftr     , Md          , Md          , Md          , Md          , Hh          , Hh          , Hh          , Hh          , Md          , Md          , Md          
Hh          , Gll^Ftr     , Gll^Ftr     , Gll^Ftr     , Gll^Ftr     , Gll^Ftr     , Gll^Ftr     , Md^Xm       , Md          , Md^Xm       , Md          , Md^Xm       , Md^Xm       , Md^Xm       , Md^Xm       , Md^Xm       , Md^Xm       , Md^Xm       , Md^Xm       , Md^Xm       , Md^Xm       , Md          , Md          , Md          , Gll^Ftr     , Hh          , Hh          , Gll^Ftr     , Gll^Ftr     , Md          , Md          , Md          , Md          , Hh          , Hh          , Hh          , Hh          , Hh          
Hh          , Hh          , Hh          , Hh          , Hh          , Gll^Ftr     , Gll^Ftr     , Gll^Ftr     , Gll^Ftr     , Gll^Ftr     , Gll^Ftr     , Md^Xm       , Md^Xm       , Md^Xm       , Md^Xm       , Md^Xm       , Md^Xm       , Md^Xm       , Md^Xm       , Md^Xm       , Md^Xm       , Md          , Md          , Md          , Md          , Gll^Ftr     , Gll^Ftr     , Hh          , Gll^Ftr     , Md          , Md          , Md          , Md          , Md          , Md          , Hh          , Hh          , Hh          
Gll^Ftr     , Hh          , Gll^Ftr     , Hh          , Hh          , Hh          , Hh          , Hh          , Hh          , Hh          , Hh          , Gll^Ftr     , Ce          , Ce          , Ce          , Ea          , Md          , Md          , Md          , Md^Xm       , Ce          , Md          , Md          , Md          , Md          , Md          , Gll^Ftr     , Hh          , Gll^Ftr     , Md          , Md          , Md          , Md          , Md          , Md          , Md          , Hh          , Hh          
Gll^Ftr     , Gll^Ftr     , Gll^Ftr     , Gll^Ftr     , Gll^Ftr     , Hh          , Gll^Ftr     , Hh          , Gll^Ftr     , Hh          , Hh          , Ce          , Ce          , Ce          , Gll^Ftr     , Gll^Ftr     , Gll^Ftr     , Md          , Md          , Ce          , Ce          , Md          , Md          , Md          , Md          , Md          , Md          , Hh          , Hh          , Gll^Ftr     , Md          , Md          , Md          , Md          , Md          , Md          , Hh          , Hh          
Gll^Ftr     , Gll^Ftr     , Gll^Ftr     , Gll^Ftr     , Md          , Gll^Ftr     , Md          , Gll^Ftr     , Gll^Ftr     , Hh          , Ce          , Ce          , Ce          , Gll^Ftr     , Gll^Ftr     , Gll^Ftr     , Gll^Ftr     , Gll^Ftr     , Gll^Ftr     , Ce          , Ce          , Md          , Md          , Md          , Md          , Md          , Md          , Hh          , Hh          , Gll^Ftr     , Md          , Md          , Md          , Md          , Md          , Hh          , Md          , Md          
Gll^Ftr     , Gll^Ftr     , Gll^Ftr     , Md          , Md          , Md          , Md          , Gll^Ftr     , Gll^Ftr     , Gll^Ftr     , Ce          , Ce          , Gll^Ftr     , Gll^Ftr     , Rp          , Gll^Ftr     , Gll^Ftr     , Gll^Ftr     , Gll^Ftr     , Ce          , Ce          , Gll^Ftr     , Gll^Ftr     , Gll^Ftr     , Gll^Ftr     , Md          , Hh          , Gll^Ftr     , Hh          , Hh          , Hh          , Md          , Md          , Md          , Hh          , Hh          , Md          , Md          
Gll^Ftr     , Gll^Ftr     , Gll^Ftr     , Md          , Md          , Md          , Md          , Md          , Md          , Ce          , Ce          , Ce          , Gll^Ftr     , Gll^Ftr     , Gll^Ftr     , Gll^Ftr     , Gll^Ftr     , Gll^Ftr     , Gll^Ftr     , Ce          , Ce          , Hh          , Hh          , Gll^Ftr     , Hh          , Hh          , Hh          , Hh          , Gll^Ftr     , Gll^Ftr     , Md          , Hh          , Hh          , Md          , Hh          , Md          , Md          , Md          
Gll^Ftr     , Gll^Ftr     , Hh          , Gll^Ftr     , Md          , Md          , Md          , Md          , Md          , Md          , Md          , Gll^Ftr     , Md          , Gll^Ftr     , Gll^Ftr     , Gll^Ftr     , Gll^Ftr     , Gll^Ftr     , Md          , Ce          , Ce          , Gll^Ftr     , Gll^Ftr     , Hh          , Gll^Ftr     , Gll^Ftr     , Gll^Ftr     , Gll^Ftr     , Md          , Md          , Md          , Md          , Md          , Hh          , Hh          , Md          , Md          , Md          
Hh          , Hh          , Hh          , Gll^Ftr     , Md          , Md          , Md          , Md          , Md          , Md          , Md          , Md          , Md          , Md          , Md          , Gll^Ftr     , Md          , Md          , Md          , Ce          , Ce          , Md          , Md          , Gll^Ftr     , Gll^Ftr     , Gll^Ftr     , Gll^Ftr     , Gll^Ftr     , Md          , Md          , Md          , Md          , Md          , Md          , Hh          , Hh          , Hh          , Md          
Gg          , Hh          , Hh          , Hh          , Hh          , Md          , Md          , Md          , Md          , Md          , Md          , Md          , Md          , Md          , Md          , Md          , Md          , Md          , Md          , Ce          , Md          , Md          , Md          , Md          , Md          , Gll^Ftr     , Md          , Md          , Md          , Md          , Md          , Md          , Md          , Md          , Md          , Hh          , Hh          , Hh          
Gll^Ftr     , Gll^Ftr     , Gll^Ftr     , Hh          , Hh          , Hh          , Gll^Ftr     , Md          , Gll^Ftr     , Md          , Md          , Md          , Md          , Md          , Md          , Md          , Md          , Md          , Md          , Md          , Md          , Md          , Md          , Md          , Md          , Md          , Md          , Md          , Md          , Md          , Md          , Md          , Md          , Md          , Md          , Md          , Hh          , Hh          
Gll^Ftr     , Gll^Ftr     , Gll^Ftr     , Gll^Ftr     , Gll^Ftr     , Hh          , Gll^Ftr     , Gll^Ftr     , Gll^Ftr     , Gll^Ftr     , Gll^Ftr     , Gll^Ftr     , Gll^Ftr     , Md          , Md          , Md          , Md          , Md          , Md          , Md          , Md          , Md          , Md          , Md          , Md          , Md          , Md          , Md          , Md          , Md          , Md          , Md          , Md          , Md          , Md          , Md          , Hh          , Hh          
Gll^Ftr     , Gll^Ftr     , Gll^Ftr     , Gll^Ftr     , Gll^Ftr     , Gll^Ftr     , Ce          , Gll^Ftr     , Ce          , Gll^Ftr     , Ce          , Gll^Ftr     , Ce          , Gll^Ftr     , Md          , Md          , Md          , Md          , Md          , Md          , Md          , Md          , Md          , Md          , Md          , Md          , Md          , Md          , Md          , Md          , Md          , Md          , Md          , Md          , Md          , Md          , Hh          , Hh          
Gll^Ftr     , Gll^Ftr     , Md          , Md          , Md          , Md          , Ce          , Ce          , Ce          , Ce          , Ce          , Ce          , Ce          , Ce          , Md          , Md          , Md          , Md          , Md          , Md          , Md          , Md          , Md          , Md          , Md          , Md          , Md          , Md          , Md          , Md          , Md          , Md          , Md          , Md          , Md          , Md          , Hh          , Hh          
Md          , Md          , Md          , Md          , Md          , Gll^Ftr     , Gll^Ftr     , Gll^Ftr     , Gll^Ftr     , Gll^Ftr     , Gll^Ftr     , Gll^Ftr     , Hh          , Md          , Md          , Md          , Md          , Md          , Md          , Md          , Md          , Md          , Md          , Md          , Md          , Md          , Md          , Md          , Md          , Md          , Md          , Md          , Md          , Hh          , Hh          , Hh          , Hh          , Hh          
Md          , Md          , Md          , Md          , Md          , Gll^Ftr     , Gg          , Ea          , Gg          , Gg          , Gg          , Ea          , Gll^Ftr     , Hh          , Hh          , Md          , Md          , Md          , Md          , Md          , Md          , Md          , Md          , Md          , Md          , Md          , Md          , Md          , Md          , Md          , Md          , Md          , Hh          , Hh          , Hh          , Hh          , Hh          , Hh          
Md          , Md          , Md          , Md          , Gll^Ftr     , Gll^Ftr     , Gg          , Gg          , Gg          , Gg          , Gg          , Gg          , Gll^Ftr     , Gll^Ftr     , Hh          , Md          , Gll^Ftr     , Md          , Md          , Md          , Md          , Md          , Md          , Md          , Md          , Md          , Md          , Md          , Md          , Md          , Md          , Md          , Md          , Hh          , Hh          , Hh          , Hh          , Hh          
Md          , Md          , Gll^Ftr     , Gll^Ftr     , Gll^Ftr     , Gg          , Gg          , Gg          , Gg          , Gg          , Gg          , Gg          , Gg          , Gll^Ftr     , Hh          , Hh          , Hh          , Gll^Ftr     , Gll^Ftr     , Md          , Gll^Ftr     , Md          , Md          , Md          , Md          , Md          , Md          , Md          , Md          , Md          , Md          , Md          , Md          , Md          , Hh          , Hh          , Hh          , Hh          
Md          , Md          , Md          , Gll^Ftr     , Gll^Ftr     , Gg          , Gg          , Gg          , Gg          , Rp          , Gg          , Gg          , Gg          , Gg          , Gll^Ftr     , Hh          , Hh          , Hh          , Hh          , Gll^Ftr     , Hh          , Gll^Ftr     , Gll^Ftr     , Gll^Ftr     , Gll^Ftr     , Gll^Ftr     , Gll^Ftr     , Md          , Gll^Ftr     , Md          , Gll^Ftr     , Hh          , Hh          , Hh          , Hh          , Hh          , Hh          , Hh          
Md          , Md          , Md          , Gll^Ftr     , Gll^Ftr     , Gg          , Gg          , Gg          , Gg          , Gg          , Gg          , Gg          , Gg          , Gll^Ftr     , Gll^Ftr     , Gll^Ftr     , Gll^Ftr     , Gll^Ftr     , Gll^Ftr     , Hh          , Gll^Ftr     , Hh          , Hh          , Hh          , Hh          , Hh          , Hh          , Hh          , Hh          , Gll^Ftr     , Hh          , Hh          , Hh          , Hh          , Hh          , Hh          , Hh          , Hh          
Md          , Md          , Md          , Md          , Gll^Ftr     , Gll^Ftr     , Gll^Ftr     , Gg          , Gg          , Gg          , Gg          , Gg          , Gg          , Gll^Ftr     , Gll^Ftr     , Gll^Ftr     , Gll^Ftr     , Gll^Ftr     , Gll^Ftr     , Gll^Ftr     , Gll^Ftr     , Gll^Ftr     , Gll^Ftr     , Gll^Ftr     , Gll^Ftr     , Gll^Ftr     , Gll^Ftr     , Gll^Ftr     , Gll^Ftr     , Hh          , Gll^Ftr     , Hh          , Gll^Ftr     , Hh          , Hh          , Hh          , Hh          , Hh          
Md          , Md          , Hh          , Hh          , Hh          , Gll^Ftr     , Gll^Ftr     , Gg          , Gll^Ftr     , Gg          , Gg          , Gg          , Hh          , Hh          , Md          , Gll^Ftr     , Md          , Md          , Md          , Md          , Md          , Md          , Md          , Md          , Md          , Md          , Md          , Gll^Ftr     , Md          , Gll^Ftr     , Md          , Gll^Ftr     , Md          , Hh          , Md          , Hh          , Md          , Hh          
Gg          , Hh          , Hh          , Hh          , Hh          , Hh          , Hh          , Gll^Ftr     , Gll^Ftr     , Gll^Ftr     , Gll^Ftr     , Gll^Ftr     , Hh          , Md          , Md          , Md          , Md          , Md          , Md          , Md          , Md          , Md          , Md          , Md          , Md          , Md          , Md          , Md          , Md          , Md          , Md          , Md          , Md          , Md          , Md          , Md          , Md          , Md          
