border_size=1
usage=map

Wog         , Wog         , Wog         , Wog         , Wog         , Wog         , Wog         , Wog         , Wog         , Gll^Fp      , Gll^Fp      , Gll^Fp      , Gll^Fp      , Gll^Fp      , Gll^Fp      , Gll^Fp      , Gll^Fp      , Gll^Fp      , Md          , Md          , Md          , Wwt         , Wwt         , Wwt         , Wwt         , Md          , Md          , Md          , Md          , Md          , Md          , Md          
Wog         , Wog         , Wog         , Wog         , Wog         , Gll^Fp      , Gll^Fp      , Gll^Fp      , Gll^Fp      , Gll^Fp      , Gll^Fp      , Gll^Fp      , Gll^Fp      , Gll^Fp      , Gll^Fp      , Gll^Fp      , Md          , Gll^Fp      , Md          , Md          , Md          , Md          , Wwt         , Wwt         , Wwt         , Md          , Md          , Md          , Md          , Md          , Md          , Gs^Fds      
Wog         , Wog         , Wog         , Wog         , Gll^Fp      , Gll^Fp      , Gll^Fp      , Gll^Fp      , Gll^Efm     , Gll^Fmw     , Gll^Fp      , Gll^Fp      , Gll^Fp      , Gll^Fmw     , Gll^Fp      , Md          , Md          , Md          , Md          , Md          , Md          , Wwt         , Wwt         , Wwt         , Md          , Md          , Md          , Md          , Md          , Md          , Md          , Gs^Fds      
Wog         , Wog         , Gll^Fdw     , Gll^Fdw     , Gll^Fp      , Gll^Fp      , Gll^Fp      , Gll^Fp      , Gll         , Gll         , Gll         , Gll^Efm     , Md          , Md          , Md          , Md          , Md          , Md          , Md          , Md          , Md          , Wwt         , Wwt         , Wwt         , Md          , Md          , Md          , Md          , Md          , Md          , Gs^Fds      , Gs^Fds      
Gll^Fdw     , Gll^Fp      , Gll^Fdw     , Gll^Fdw     , Gll         , Gll^Efm     , Gll^Efm     , Gll         , Gll         , Gll^Efm     , Gll         , Gll         , Gll^Emf     , Md          , Md          , Md          , Md          , Md          , Md          , Md          , Gll^Ftr     , Wwt         , Wwt         , Md          , Md          , Md          , Md          , Md          , Gs^Fds      , Gs^Fds      , Gs^Fds      , Gs^Fds      
Gll^Fdw     , Gll^Fp      , Gll^Fdw     , Gll^Efm     , Gll^Efm     , Gll         , Gll^Efm     , Gll         , Gll^Fdw     , Gll^Fdw     , Gll^Gvs     , Gll^Gvs     , Gll^Gvs     , Gll^Emf     , Md          , Md          , Md          , Md          , Gll^Ftr     , Gll^Ftr     , Gll^Ftr     , Wwt         , Ch          , Ea          , Rrc         , Md          , Ch          , Ch          , Ch          , Gs^Fds      , Gs^Fds      , Gs^Fds      
Gll^Fp      , Gll^Fdw     , Gll^Fdw     , Gll         , Gll         , Gll         , Gll         , Gll         , Gll         , Gll         , Gll^Gvs     , Gll^Eff     , Gll^Gvs     , Gll^Gvs     , Gll^Gvs     , Md          , Md          , Gll^Ftr     , Gll^Ftr     , Gll^Ftr     , Ch          , Ch          , Rrc         , Rrc         , Rrc         , Rrc         , Rrc         , Ch          , Ch          , Ch          , Ch          , Gs^Fds      
Gll^Fdw     , Gll^Fdw     , Gll^Fdw     , Gll         , Gll^Efm     , Gll         , Gll         , Gll^Efm     , Gll^Efm     , Gll         , Gll^Gvs     , Gll^Gvs     , Gll^Eff     , Gll^Gvs     , Gll^Fdw     , Gll^Es      , Gll^Ftr     , Gll^Ftr     , Gll^Ftr     , Ch          , Rrc         , Rrc         , Rrc         , Rrc         , Rrc         , Rrc         , Rrc         , Rrc         , Rrc         , Ch          , Ch          , Ch          
Gg          , Gll^Fdw     , Gll^Fdw     , Gll^Fdw     , Gll^Fdw     , Gll^Fdw     , Gll^Fdw     , Gll         , Gll^Fdw     , Gll         , Gll^Fdw     , Gll^Fdw     , Gll^Fdw     , Gll^Fdw     , Gll^Fdw     , Gll^Ftr     , Md          , Gll^Ftr     , Md          , Ch          , Rrc         , Rrc         , Rrc         , Rrc         , Rrc         , Rrc         , Rrc         , Rrc         , Rrc         , Rrc         , Ch          , Ch          
Wot         , Gll^Fdw     , Wot         , Gll^Fdw     , Wot         , Gll^Fdw     , Gll^Fdw     , Gll^Fdw     , Wot         , Gll^Fdw     , Wwr         , Wwr         , Hh          , Hh          , Md          , Md          , Md          , Md          , Md          , Md          , Md          , Rrc         , Rrc         , Rrc         , Rrc         , Rr          , Rrc         , Rrc         , Rrc         , Rrc         , Ch          , Ch          
Wot         , Wot         , Wot         , Wot         , Wot         , Wot         , Wot^Bw|     , Wot         , Wot         , Wwr         , Hh          , Hh          , Hh          , Hh          , Md          , Md          , Md          , Md          , Md          , Md          , Rrc         , Rrc         , Rrc         , Rrc         , Rrc         , Rrc         , Rrc         , Rrc         , Rrc         , Rrc         , Ch          , Ch          
Wot         , Wot         , Wot         , Wot         , Wot         , Wot         , Wot^Bw|     , Wot         , Wot         , Wwr         , Hh          , Hh          , Md          , Md          , Md          , Md          , Md          , Md          , Md          , Md          , Ch          , Rrc         , Rrc         , Rrc         , Rrc         , Rrc         , Rrc         , Rrc         , Rrc         , Rrc         , Ch          , Ch          
Wot         , Wot         , Wot         , Wot         , Wot         , Wot         , Wot^Bw|     , Wot         , Wot         , Wwr         , Wot         , Md          , Gll^Ftr     , Md          , Wot         , Md          , Gll^Ftr     , Gll^Ftr     , Gll^Ftr     , Ch          , Ch          , Ch          , Ch          , Rrc         , Ch          , Rrc         , Ch          , Rrc         , Ea          , Ch          , Gs^Fds      , Gs^Fds      
Wot         , Wot         , Wot         , Wot         , Wot         , Wot         , Wot^Bw|     , Wot         , Wot         , Wot         , Wot         , Wot         , Wot         , Wot         , Wot         , Wot         , Wot         , Gll^Ftr     , Gll^Ftr     , Gll^Ftr     , Gll^Ftr     , Ch          , Ch          , Ch          , Ch          , Ch          , Ch          , Ch          , Md          , Md          , Md          , Gs^Fds      
Wot         , Wot         , Wot         , Wot         , Wot         , Wot         , Gll^Fdw     , Wot         , Wot         , Wot         , Wot         , Wot         , Wot         , Wot         , Wot         , Wot         , Wot         , Wot         , Wot         , Md          , Md          , Gll^Ftr     , Gll^Ftr     , Md          , Md          , Md          , Md          , Md          , Md          , Md          , Gs^Fds      , Gs^Fds      
Wot         , Wot         , Wot         , Wot         , Gll^Fdw     , Gll         , Gll         , Wot         , Gll^Fdw     , Wot         , Wot         , Wot         , Wot         , Wot         , Wot         , Wot         , Wot         , Wot         , Md          , Md          , Md          , Md          , Md          , Md          , Md          , Md          , Md          , Md          , Md          , Gs^Fds      , Gs^Fds      , Gs^Fds      
Wot         , Wot         , Gll^Fdw     , Gll^Fdw     , Gll^Fdw     , Gll         , Gll^Fdw     , Gll^Fdw     , Gll^Fdw     , Wot         , Wot         , Wot         , Wot         , Wot         , Wot         , Wot         , Md          , Md          , Md          , Md          , Md          , Md          , Md          , Md          , Md          , Md          , Md          , Md          , Md          , Md          , Wot         , Gs^Fds      
Ss          , Gg^Emf      , Gll         , Gll^Fdw     , Gll         , Gll         , Gll^Emf     , Gll^Fdw     , Gll^Fdw     , Wot         , Wot         , Wot         , Wot         , Wot         , Wot         , Wot         , Wot         , Md          , Md          , Md          , Md          , Md          , Md          , Md          , Md          , Md          , Md          , Md          , Md          , Md          , Wot         , Wot         
Ss          , Ss          , Ss          , Gll         , Gll         , Gll         , Ss          , Ss          , Ss          , Wot         , Wot         , Wot         , Wot         , Wot         , Wot         , Wot         , Wot         , Wot         , Wot         , Md          , Md          , Md          , Wot         , Md          , Wot         , Md          , Wot         , Md          , Wot         , Wot         , Wot         , Wot         
Ss          , Ss          , Ss          , Ss          , Ss          , Gll         , Ss          , Ss          , Ss          , Wot         , Wot         , Wot         , Wot         , Wot         , Wot         , Wot         , Wot         , Wot         , Wot         , Wot         , Wot         , Wot         , Wot         , Wot         , Wot         , Wot         , Wot         , Wot         , Wot         , Wot         , Wot         , Wot         
Gll^Fp      , Ss          , Ss          , Ss          , Ss          , Gll         , Gll         , Ss          , Ss          , Ss          , Ss          , Wot         , Wot         , Wot         , Wot         , Wot         , Wot         , Wot         , Wot         , Wot         , Wot         , Wot         , Wot         , Wot         , Wot         , Wot         , Wot         , Wot         , Wot         , Wot         , Wot         , Wot         
Gll^Fp      , Gll^Fp      , Gll^Fp      , Ss          , Gll^Fp      , Ss          , Ss          , Gll         , Ss          , Ss          , Ss          , Ss          , Wot         , Wot         , Wot         , Wot         , Wot         , Wot         , Wot         , Wot         , Wot         , Wot         , Wot         , Wot         , Wot         , Wot         , Wot         , Wot         , Wot         , Wot         , Wot         , Wot         
Gll^Fp      , Gll^Fp      , Gll^Fp      , Md          , Md          , Gll^Fp      , Gll^Fp      , Gll         , Gll^Fp      , Ss          , Gll^Fp      , Ss          , Wot         , Wot         , Wot         , Wot         , Wot         , Wot         , Wot         , Wot         , Wot         , Wot         , Wot         , Wot         , Wot         , Wot         , Wot         , Wot         , Wot         , Wot         , Wot         , Wot         
Gll^Fp      , Gll^Fp      , Gll^Fp      , Md          , Hh          , Hh          , Gll^Fp      , Gll         , Gll^Fp      , Gll^Fp      , Gll^Fp      , Gll^Fp      , Gll^Fp      , Wot         , Gll^Fp      , Wot         , Wot         , Wot         , Wot         , Wot         , Wot         , Wot         , Gll^Ftr     , Wot         , Wot         , Wot         , Wot         , Wot         , Wot         , Wot         , Wot         , Wot         
Gll^Fp      , Gll^Fp      , Gll^Fp      , Hh          , Hh          , Gll^Fp      , Gll^Fp      , Gll         , Gll^Fp      , Gll^Fp      , Gll^Fp      , Gll^Fp      , Gll^Fp      , Gll^Fp      , Gll^Fp      , Md          , Md          , Md          , Md          , Md          , Gll^Ftr     , Gll^Ftr     , Gll^Ftr     , Gll^Ftr     , Gll^Ftr     , Wot         , Wot         , Wot         , Wot         , Wot         , Wot         , Wot         
Md          , Gll^Fp      , Md          , Hh          , Gll^Fp      , Gll^Fp      , Gll^Fp      , Gll         , Gll         , Gll^Fp      , Gll^Fp      , Gll^Fp      , Gll^Fp      , Gll^Fp      , Gll^Fp      , Gll^Fp      , Gll^Fp      , Md          , Md          , Md          , Wwg         , Wwg         , Wwg         , Gll^Ftr     , Gll^Ftr     , Wot         , Gll^Ftr     , Gll^Ftr     , Gll^Ftr     , Wot         , Wot         , Wot         
Md          , Md          , Md          , Hh          , Hh          , Gll^Fp      , Gll^Fp      , Gll         , Gll         , Gll         , Gll         , Gll^Fp      , Gll^Fp      , Gll^Fp      , Gll^Fp      , Gll^Fp      , Gll^Fp      , Wwg         , Wwg         , Wwg         , Wwg         , Wwg         , Gll^Ftr     , Gll^Ftr     , Gll^Ftr     , Gll^Ftr     , Md          , Gll^Ftr     , Md          , Gll^Ftr     , Gll^Ftr     , Wot         
Md          , Md          , Md          , Md          , Hh          , Gll^Fp      , Gll^Fp      , Gll^Fp      , Gll^Fp      , Gll         , Gll         , Gll         , Gll^Fp      , Gll^Fp      , Gll^Fp      , Gll^Fp      , Wwg         , Wwg         , Wwg         , Wwg         , Gll^Ftr     , Gll^Ftr     , Md          , Md          , Md          , Md          , Md          , Md          , Md          , Md          , Gll^Ftr     , Gll^Ftr     
Md          , Md          , Md          , Md          , Md          , Gll^Fp      , Gll^Fp      , Gll^Fp      , Gll^Fp      , Gll^Fp      , Gll^Fp      , Gll         , Gll         , Gll^Fp      , Gll^Fp      , Gll^Fp      , Wwg         , Wwg         , Wwg         , Gll^Ftr     , Gll^Ftr     , Md          , Md          , Md          , Wwg         , Md          , Gg          , Md          , Gg          , Md          , Md          , Gs^Ftp      
Md          , Md          , Md          , Md          , Md          , Md          , Md          , Gll^Fp      , Gll^Fp      , Gll^Fp      , Gll^Fp      , Gll^Fp      , Gll^Fp      , Gll         , Wwg         , Wwg         , Wwg         , Wwg         , Gll^Ftr     , Gll^Ftr     , Gll^Ftr     , Md          , Gg          , Wwg         , Gg          , Wwg         , Wwg         , Wwg         , Gg          , Wwg         , Gs^Ftp      , Gs^Ftp      
Md          , Md          , Md          , Md          , Md          , Md          , Md          , Md          , Md          , Gll^Fp      , Gll^Fp      , Gll^Fp      , Wwg         , Wwg         , Wwg         , Wwg         , Wwg         , Gll^Ftr     , Wwg         , Gs^Ftp      , Wwg         , Gg          , Gg          , Gg          , Wwg         , Gg          , Wwg         , Gg          , Gg          , Wwg         , Gs^Ftp      , Gs^Ftp      
Md          , Wwg         , Wwg         , Wwg         , Wwg         , Wwg         , Wwg         , Wwg         , Wwg         , Wwg         , Wwg         , Wwg         , Wwg         , Wwg         , Wwg         , Wwg         , Md          , Gll^Ftr     , Wwg         , Wwg         , Wwg         , Wwg         , Wwg         , Gg          , Wwg         , Wwg         , Gg          , Gg          , Gg          , Wwg         , Md          , Md          
Md          , Md          , Wwg         , Wwg         , Wwg         , Wwg         , Wwg         , Wwg         , Qxu^Bs|     , Wwg         , Qxu^Bs|     , Wwg         , Qxu^Bs|     , Wwg         , Qxu^Bs|     , Md          , Md          , Md          , Wwg         , Wwg         , Wwg         , Wwg         , Wwg         , Wwg         , Gg          , Gg          , Gg          , Wwg         , Gg          , Wwg         , Md          , Md          
Md          , Md          , Md          , Wwg         , Md          , Wwg         , Wwg         , Wwg         , Cud         , Wwg         , Cud         , Wwg         , Cud         , Wwg         , Cud         , Md          , Md          , Md          , Wwg         , Wwg         , Wwg         , Wwg         , Gg          , Gg          , Gg          , Gg          , Gg          , Gg          , Gg          , Md          , Md          , Md          
Md          , Md          , Hd          , Md          , Md          , Md          , Md          , Md          , Md          , Urb         , Urb         , Urb         , Urb         , Urb         , Gll         , Gll         , Gll         , Wwg         , Wwg         , Wwg         , Wwg         , Gs^Ftp      , Gs^Ftp      , Wwg         , Gg          , Gg          , Gg          , Gg          , Wwt         , Wwt         , Wwt         , Wwt         
Md          , Md          , Md          , Md          , Md          , Md          , Md          , Md          , Md          , Urb         , Urb         , Urb         , Urb         , Urb         , Md          , Gll         , Gll         , Wwg         , Gll         , Wwg         , Gll         , Wwg         , Wwg         , Gs^Ftp      , Gs^Ftp      , Gg          , Gg          , Gg          , Wwt^Bw\r    , Wwt         , Wwt         , Wwt         
Md          , Md          , Md          , Md          , Md          , Md          , Md          , Md          , Md          , Cud         , Cud         , Cud         , Cud         , Cud         , Md          , Md          , Md          , Gll         , Gll         , Gll         , Wwf         , Gll         , Gll         , Gs^Ftp      , Gs^Ftp      , Gs^Ftp      , Gs^Ftp      , Wwt         , Wwt         , Wwt^Bw\r    , Wwt^Bw\r    , Wwt         
Md          , Md          , Md          , Md          , Md          , Md          , Md          , Md          , Md          , Urb         , Urb         , Urb         , Urb         , Urb         , Md          , Md          , Md          , Gll         , Md          , Gll         , Gll         , Gll         , Gll         , Wwr         , Wwr         , Gs^Ftp      , Gll         , Wwt         , Wwt         , Wwt         , Wwt         , Wwt^Bw\r    
Gg^Fet      , Md          , Md          , Md          , Md          , Md          , Md          , Md          , Md          , Urb         , Urb         , Urb         , Urb         , Urb         , Md          , Md          , Md          , Md          , Md          , Md          , Wwg         , Gll         , Gll         , Wwr         , Wwr         , Wwr         , Gll         , Gll         , Gll         , Wwt         , Wwt         , Wwt         
Gg^Fet      , Gg^Fet      , Gg^Fet      , Gg^Fet      , Qxe         , Ea          , Rrc         , Rrc         , Rrc         , Rrc         , Rrc         , Rrc         , Rrc         , Rrc         , Rrc         , Rrc         , Ea          , Qxe         , Qxe         , Md          , Wwg         , Wwg         , Wwg         , Gll         , Wwr         , Wwr         , Gll         , Gll         , Wwt         , Wwt         , Wwt         , Gll^Fp      
Gg^Fet      , Gg^Fet      , Gg^Fet      , Gg^Fet      , Qxe         , Gg^Fet      , Rrc         , Rrc         , Rrc         , Rrc         , Rrc         , Rrc         , Rrc         , Rrc         , Rrc         , Rrc         , Gg^Fet      , Gg^Fet      , Qxe         , Md          , Wwg         , Wwg         , Wwg         , Gll         , Gll         , Gll         , Gll         , Gll         , Wwt         , Wwt         , Gll^Fp      , Gll^Fp      
Gg^Fet      , Gg^Fet      , Gg^Fet      , Gg^Fet      , Qxe         , Gg^Fet      , Rrc         , Rrc         , Rrc         , Rrc         , Rrc         , Rp          , Rrc         , Rrc         , Rrc         , Rrc         , Gg^Fet      , Gg^Fet      , Qxe         , Wwg         , Wwg         , Wwg         , Ss          , Ss          , Gll         , Gll         , Gll         , Gll         , Wwt         , Wwt         , Gll^Ftr     , Gll^Fp      
Gg^Fet      , Gg^Fet      , Gg^Fet      , Gg^Fet      , Qxe         , Gg^Fet      , Rrc         , Rrc         , Rrc         , Rrc         , Rrc         , Rrc         , Rrc         , Rrc         , Rrc         , Rrc         , Gg^Fet      , Gg^Fet      , Qxe         , Ss          , Ss          , Wwg         , Wwg         , Ss          , Ss          , Wwt         , Wwt         , Wwt         , Wwt         , Gll^Ftr     , Gll^Ftr     , Gll^Ftr     
Gg^Fet      , Gg^Fet      , Gg^Fet      , Gg^Fet      , Qxe         , Gg^Fet      , Rrc         , Rrc         , Rrc         , Rrc         , Rrc         , Rrc         , Rrc         , Rrc         , Rrc         , Rrc         , Gg^Fet      , Gg^Fet      , Qxe         , Ss          , Ss          , Wwg         , Wwg         , Ss          , Ss          , Ss          , Ss          , Gll         , Gll         , Hh          , Hh          , Hh          
Gg^Fet      , Gg^Fet      , Gg^Fet      , Gg^Fet      , Qxe         , Gg^Fet      , Cud         , Rrc         , Cud         , Rrc         , Cud         , Rrc         , Cud         , Rrc         , Cud         , Rrc         , Cud         , Gg^Fet      , Qxe         , Ss          , Wwg         , Wwg         , Wwg         , Wwg         , Ss          , Ss          , Md          , Md          , Gll         , Md          , Md          , Hh          
Gg^Fet      , Gg^Fet      , Gg^Fet      , Gg^Fet      , Qxe         , Ea          , Wwg         , Cud         , Wwg         , Cud         , Rrc         , Cud         , Rrc         , Cud         , Rrc         , Cud         , Ea          , Gg^Fet      , Qxe         , Wwg         , Ss          , Wwg         , Wwg         , Wwg         , Ss          , Ss          , Md          , Md          , Gll         , Md          , Md          , Md          
Wwg         , Wwg         , Wwg         , Wwrg        , Wwrg        , Qxe         , Qxe         , Qxu^Bs|     , Wwg         , Qxu^Bs|     , Wwg         , Qxu^Bs|     , Wwg         , Qxu^Bs|     , Wwg         , Qxu^Bs|     , Qxe         , Qxe         , Ss          , Ss          , Ss          , Ss          , Ss          , Ss          , Ss          , Ss          , Gll         , Gll         , Gll         , Gll         , Ss          , Ss          
Sm          , Ss          , Ss          , Ss          , Ss          , Wwrg        , Qxe         , Cud         , Ss          , Cud         , Ss          , Cud         , Ss          , Cud         , Ss          , Cud         , Qxe         , Ss          , Ss          , Ss          , Ss          , Ss          , Ss          , Ss          , Ss          , Ss          , Gll         , Gll         , Gll         , Gll         , Gll         , Ss          
Sm          , Sm          , Sm          , Sm          , Ss          , Ss          , Qxe         , Ss          , Qxe         , Qxe         , Qxe         , Ss          , Qxe         , Qxe         , Qxe         , Sm          , Qxe         , Sm          , Sm          , Ss          , Ss          , Ss          , Ss          , Ss          , Ss          , Gll         , Gll         , Gll         , Gll         , Gll         , Gll         , Ss          
Sm          , Sm          , Sm          , Sm          , Ss          , Ss          , Ss          , Sm          , Sm          , Sm          , Sm          , Sm          , Sm          , Sm          , Sm          , Sm          , Sm          , Sm          , Ss          , Ss          , Ss          , Ss          , Ss          , Ss          , Wwg         , Gll         , Gll         , Gll         , Gll         , Gll         , Gll         , Ss          
Md          , Md          , Md          , Ss          , Ss          , Ss          , Ss          , Md          , Md          , Md          , Md          , Md          , Md          , Md          , Md          , Sm          , Md          , Ss          , Ss          , Ss          , Ss          , Ss          , Wwg         , Wwg         , Wwg         , Wwg         , Ch          , Gll         , Gll         , Gll         , Gll         , Gll         
Md          , Md          , Md          , Md          , Ss          , Ss          , Ss          , Md          , Md          , Md          , Md          , Md          , Md          , Md          , Md          , Md          , Md          , Ss          , Ss          , Ss          , Ch          , Wwg         , Gll         , Wwg         , Gll         , Gll         , Gll         , Ch          , Ch          , Gll         , Gll         , Gll         
Gll^Ftr     , Md          , Md          , Md          , Ss          , Ss          , Ss          , Ss          , Ss          , Md          , Md          , Md          , Md          , Md          , Md          , Md          , Wwg         , Wwg         , Wwg         , Ch          , Ch          , Ch          , Gll         , Gll         , Gll         , Ea          , Gll         , Gll         , Ch          , Ch          , Wwg         , Wwg         
Wwg         , Md          , Md          , Md          , Wwg         , Md          , Md          , Md          , Md          , Wwg         , Md          , Gll^Ftr     , Gll^Ftr     , Md          , Md          , Wwg         , Wwg         , Wwg         , Wwg         , Ch          , Ch          , Ch          , Gll         , Gll         , Gll         , Rp          , Gll         , Gll         , Ch          , Ch          , Wwg         , Wwg         
Wwg         , Wwg         , Wwg         , Wwg         , Wwg         , Wwg         , Md          , Md          , Md          , Md          , Md          , Md          , Md          , Md          , Gll^Ftr     , Gll^Ftr     , Gll^Ftr     , Wwg         , Wwg         , Ch          , Ch          , Ch          , Gll         , Gll         , Gll         , Ea          , Gll         , Gll         , Ch          , Ch          , Gll^Ftr     , Gll^Ftr     
Wwg         , Wwg         , Hh          , Wwg         , Wwg         , Wwg         , Gll         , Gll         , Gll         , Md          , Md          , Md          , Md          , Gll^Ftr     , Gll         , Gll^Ftr     , Gll^Ftr     , Gll^Ftr     , Gll^Ftr     , Ch          , Ch          , Ch          , Ch          , Ch          , Ch          , Ch          , Ch          , Ch          , Ch          , Ch          , Gll^Ftr     , Gll^Ftr     
Md          , Wwg         , Md          , Md          , Md          , Gll         , Gll         , Gll         , Gll         , Gll         , Gll         , Md          , Gll         , Gll         , Gll         , Gll         , Gll         , Ss          , Gll         , Ch          , Ch          , Ch          , Gll^Ftr     , Ch          , Ch          , Ch          , Ch          , Ch          , Ch          , Ch          , Hh          , Gll^Ftr     
Md          , Md          , Md          , Md          , Gll         , Gll         , Gll         , Gll         , Gll         , Gll         , Gll         , Gll         , Gll         , Gll         , Gll         , Gll         , Gll         , Gll         , Gll         , Gll         , Gll^Ftr     , Gll^Ftr     , Gll^Ftr     , Gll^Ftr     , Gll^Ftr     , Gll^Ftr     , Gll^Ftr     , Gll         , Gll^Ftr     , Hh          , Hh          , Hh          
Md          , Md          , Md          , Md          , Md          , Gll         , Gll         , Gll         , Gll         , Gll         , Gll         , Gll         , Gll         , Gll         , Gll         , Gll         , Gll         , Gll         , Gll^Ftr     , Gll         , Gll^Ftr     , Gll^Ftr     , Gll^Ftr     , Gll^Ftr     , Gll^Ftr     , Gll^Ftr     , Gll^Ftr     , Gll^Ftr     , Gll^Ftr     , Hh          , Hh          , Hh          
Gll^Ftr     , Md          , Md          , Md          , Md          , Md          , Gll         , Gll         , Gll         , Gll         , Ss          , Ss          , Ss          , Gll         , Gll         , Gll         , Gll^Ftr     , Gll^Ftr     , Gll^Ftr     , Gll^Ftr     , Gll^Ftr     , Gll^Ftr     , Gll^Ftr     , Gll^Ftr     , Gll^Ftr     , Gll^Ftr     , Gll^Ftr     , Gll^Ftr     , Gll^Ftr     , Gll^Ftr     , Hh          , Hh          
Gll^Ftr     , Gll^Ftr     , Gll^Ftr     , Md          , Gll^Ftr     , Md          , Gll^Ftr     , Gll         , Gll^Ftr     , Gll^Ftr     , Gll^Ftr     , Gll^Ftr     , Gll^Ftr     , Gll^Ftr     , Gll^Ftr     , Gll^Ftr     , Gll         , Gll^Ftr     , Gll         , Gll^Ftr     , Gll         , Gll^Ftr     , Gll^Ftr     , Gll^Ftr     , Gll^Ftr     , Gll         , Md          , Md          , Md          , Md          , Md          , Hh          
Gll^Ftr     , Gll^Ftr     , Gll^Ftr     , Gll^Ftr     , Gll^Ftr     , Gll^Ftr     , Gll^Ftr     , Gll^Ftr     , Gll^Ftr     , Gll^Ftr     , Gll^Ftr     , Gll^Ftr     , Gll^Ftr     , Gll^Ftr     , Gll^Ftr     , Gll^Ftr     , Gll         , Gll         , Gll         , Gll         , Gll^Ftr     , Gll^Ftr     , Ss          , Gll^Ftr     , Ss          , Gll^Ftr     , Gll^Ftr     , Gll^Ftr     , Gll^Ftr     , Md          , Md          , Md          
